,id,state_code,ENTIDAD,geometry,AÑO,Categoría,POBLACIÓN,POBLACION_2023,POBLACION_2024,diferencia_poblacional,población_diferencia_absoluta,Crecimiento (%)
0,,9,Ciudad de México,"POLYGON ((-99.09052176998246 19.509262698819235, -99.06421279413962 19.49871439131244, -99.05121679402448 19.449973935936203, -99.05565445260038 19.422148228202758, -99.0581902575009 19.40068787844755, -98.99194235447494 19.367588016960703, -98.97450869578391 19.337034298665152, -98.96056176883107 19.325394786933515, -98.97672752507185 19.25301157335239, -98.94598089065312 19.224822130877328, -98.96848615914519 19.210636475954395, -98.95517318341749 19.17389926705141, -98.95770898831799 19.122430801113076, -98.9789463543598 19.07423594784926, -99.02934547675754 19.08514799009767, -99.06199396485167 19.0487745159363, -99.12538908736454 19.062050834005202, -99.1355323069666 19.08933093962623, -99.13648323380428 19.08933093962623, -99.2271382589977 19.09606003234608, -99.27912225945825 19.131706037024223, -99.30701611336391 19.2108183433252, -99.31367260122776 19.21900237501151, -99.3158914305157 19.227368274068624, -99.32223094276699 19.232460560451216, -99.32444977205495 19.232460560451216, -99.33934762584548 19.267560963016937, -99.36533962607575 19.27774553578212, -99.35646430892395 19.30320696769508, -99.32920440624342 19.35212929044212, -99.25598303974105 19.40341588900965, -99.23981728350027 19.41214552280838, -99.20875367346896 19.46979747935415, -99.20685181979357 19.471070550949797, -99.21382528326998 19.497077584975177, -99.20463299050563 19.514900587314248, -99.15740362423354 19.502897340840995, -99.1764221609874 19.531996120170092, -99.14377367289327 19.57237067648921, -99.12380420930171 19.592739822019578, -99.11809864827556 19.590557413569897, -99.11271006286196 19.573098145972438, -99.13077767277814 19.53599720232784, -99.09052176998246 19.509262698819235))",2023,Total,9221637,9237644,9221637,-16007,16007,-0.17
1,,12,Guerrero,"POLYGON ((-100.53878334378896 18.843991856407794, -100.5020141727315 18.830715538338893, -100.48204470913996 18.79870688107689, -100.43132861112966 18.783430021929114, -100.42213631836529 18.763242743769553, -100.44749436737044 18.701589705066034, -100.47348636760071 18.69085953018843, -100.48679934332841 18.639936666362512, -100.47475427005097 18.619021918719724, -100.42974373306683 18.59919837530178, -100.44939622104582 18.553731532600068, -100.42974373306683 18.51099270046046, -100.39614431813501 18.540455214531168, -100.36191095197806 18.496625178166717, -100.38536714730782 18.426424373035275, -100.35937514707754 18.423514495102367, -100.30612324416674 18.36786307963547, -100.29185934160134 18.38168499981679, -100.26808617065902 18.3793207239963, -100.25794295105696 18.42860678148496, -100.22687934102565 18.43078918993464, -100.18567251139228 18.45497755025195, -100.15936353554945 18.491532891784125, -100.08994587639785 18.522086610079675, -100.07694987628271 18.548821113588282, -100.0680745591309 18.59101434361547, -100.02179611969652 18.60374505957195, -99.96157075330929 18.55282219574603, -99.94286919216799 18.589741272019822, -99.88803241119436 18.61884005134892, -99.85855367922588 18.612656560741485, -99.78596626394864 18.63939106425009, -99.77201933699581 18.686494713289065, -99.73873689767655 18.737417577114982, -99.67217201903804 18.713411084168477, -99.70925816570806 18.768880632264565, -99.69721309243062 18.786158032491215, -99.66139484821085 18.771244908085055, -99.63128216501724 18.720322044259138, -99.62335777470312 18.73869064871063, -99.5808830426195 18.730142882282706, -99.57105679863001 18.706863858819432, -99.53333670073485 18.694133142862952, -99.49434870038944 18.720322044259138, -99.48071874904917 18.68449417221019, -99.4645529928084 18.643755881149456, -99.4636020659707 18.642482809553808, -99.4537758219812 18.609928550179383, -99.41985943143682 18.590286874132243, -99.42302918756246 18.562097431657183, -99.37928655302858 18.520449803742416, -99.35741523576164 18.46770826620843, -99.32825347940572 18.488804881222023, -99.32825347940572 18.45952423452212, -99.26897903985619 18.45315887654388, -99.20463299050563 18.455159417622756, -99.13933601431737 18.46407091879229, -99.12729094103992 18.425696903552048, -99.06674859904014 18.368226814377085, -99.07086928200347 18.334945085519433, -99.066114647815 18.332580809698943, -99.05438655015013 18.252195431802317, -99.03188128165806 18.27220084259107, -99.02332294011882 18.248376217015373, -98.98940654957443 18.2491036864986, -99.00050069601419 18.190178658357183, -98.95707503709286 18.18854185201992, -98.88512157304076 18.166899634893905, -98.85944654842305 18.12852561965366, -98.86008049964818 18.092152145492292, -98.86990674363767 18.05705174292657, -98.81285113337609 18.06469017250046, -98.7380448888109 18.039956210070727, -98.81506996266404 18.007947552808723, -98.68796274202573 17.96193510799459, -98.64485405871699 17.933381930777916, -98.58494566794232 17.973756487097035, -98.52979191135613 17.975575160805104, -98.5237693747174 17.9941256326274, -98.48700020365993 17.99085201995288, -98.4340652763617 17.983759192491412, -98.42297112992193 17.94174782983503, -98.44072176422554 17.92265175590031, -98.42487298359733 17.86572726883777, -98.42487298359733 17.839538367441584, -98.47146839864429 17.788615503615667, -98.49429064274892 17.77279304235547, -98.48985298417301 17.703319706707255, -98.47083444741915 17.677858274794296, -98.46100820342966 17.63039089101371, -98.41251093470731 17.600928376943003, -98.37700966610011 17.605111326471558, -98.33009727544058 17.533273715002856, -98.33168215350341 17.519451794821535, -98.31202966552442 17.477440432165153, -98.33231610472853 17.47180254367014, -98.33580283646674 17.45634381715156, -98.30537317766057 17.394327043706426, -98.2873055677444 17.32885479021596, -98.30505620204801 17.327581718620312, -98.3228068363516 17.27465831371552, -98.28857347019465 17.238648574295766, -98.24229503076026 17.25046995339821, -98.20330703041485 17.216097020315715, -98.21757093298024 17.186634506245007, -98.22264254278127 17.122071589608577, -98.18365454243586 17.117706772709212, -98.09870507826861 17.08387944173914, -98.08127141957758 17.06660204151249, -98.07271307803833 17.064237765692, -98.00773307746265 17.039867538003882, -98.02516673615368 17.018952790361094, -98.03055532156728 17.01567917768657, -98.0578152242478 17.02386320937288, -98.09743717581836 16.968939263389213, -98.11138410277118 16.958936557994836, -98.08095444396501 16.88491653807645, -98.07239610242577 16.87345889371562, -98.10789737103298 16.76161046066941, -98.13579122493864 16.75742751114085, -98.13927795667685 16.723600180170777, -98.23817434779693 16.70723211679816, -98.21408420124203 16.618844574586035, -98.19379776203792 16.62139071777733, -98.20584283531537 16.585926580469994, -98.29301112877056 16.557737137994934, -98.31678429971288 16.569922251838992, -98.39539425162884 16.546825095746524, -98.35704020250856 16.47735176009831, -98.34974976341958 16.44497936809469, -98.36623249527293 16.42370088571029, -98.39951493459218 16.38041645145826, -98.45403473995324 16.385690605211657, -98.53866722850793 16.347134722600607, -98.55261415546076 16.316035402192636, -98.56877991170154 16.34222430358882, -98.70286059581626 16.466075983108283, -98.72314703502038 16.49517476243738, -98.77576498670606 16.555372862174444, -98.81348508460121 16.554645392691217, -98.85691074352253 16.528274623924226, -98.90762684153283 16.534639981902465, -99.0803785503804 16.593565010043882, -99.23189289318616 16.63412143373381, -99.45504372443146 16.681588817514395, -99.56725309127924 16.689045379717477, -99.60877689652517 16.68413496070569, -99.66614948239932 16.69868435037024, -99.7542687026922 16.740877580397427, -99.81100733734122 16.7852532188743, -99.86584411831485 16.807804772854347, -99.85189719136203 16.844178247015716, -99.88359475261846 16.85945510616349, -99.91592626510003 16.84672439020701, -99.9596688996339 16.893282437133564, -100.0024606073301 16.913833450034737, -100.12100948642916 16.948751985229652, -100.2290981703136 16.990217745773613, -100.43544929409299 17.064055898321193, -100.61612539325468 17.123344661204225, -100.67508285719164 17.137348448756352, -100.77017554096095 17.175176861884175, -100.91598432274054 17.221734908810728, -101.03389925061448 17.267383618883247, -101.06464588503323 17.268656690478895, -101.05038198246783 17.291208244458943, -101.07859281198606 17.327399851249506, -101.16639505666637 17.38759795098657, -101.20570003262436 17.428336242047305, -101.26434052094876 17.456707551893174, -101.44343174204762 17.525817152799775, -101.44057896153454 17.555097799499677, -101.45579379093763 17.5796498945586, -101.51728705977511 17.623843665664666, -101.54327906000539 17.618205777169653, -101.5955800360785 17.63439197317146, -101.60255349955493 17.657307261893123, -101.6428094023506 17.6673099672875, -101.64851496337675 17.70368344144887, -101.68052950024575 17.748240947296548, -101.71539681762783 17.773884246580312, -101.7477283301094 17.793162187885837, -101.78418052555429 17.86445419724212, -101.82633828202536 17.897735926099774, -101.96802638084162 17.96830046597283, -102.0393458936686 17.988669611503198, -102.1014731137312 17.981758651412537, -102.13729135795099 17.94011102349777, -102.13792530917611 17.969755404939285, -102.17342657778332 17.98957894835723, -102.18452072422306 18.061598427196742, -102.162015455731 18.164171624331804, -102.13158579692482 18.188905586761535, -102.05836443042246 18.19490720999816, -102.03807799121834 18.20818352806706, -101.97816960044368 18.207092323842218, -101.96929428329187 18.233099357867598, -101.92903838049621 18.23128068415953, -101.90463125832875 18.247830614902952, -101.89702384362721 18.277111261602855, -101.86215652624513 18.28838703859288, -101.86183955063257 18.356223567903832, -101.8881485264754 18.40987444229185, -101.8605716481823 18.446066049082415, -101.88688062402514 18.477165369490386, -101.87959018493616 18.53918214293552, -101.8561339896064 18.559551288465887, -101.8437719407164 18.57428254550124, -101.77213545227686 18.60374505957195, -101.713811939565 18.61011041755019, -101.70335174435039 18.588286333053368, -101.63900569499982 18.602290120605495, -101.60540628006801 18.574464412872047, -101.58797262137696 18.52645142697904, -101.5014382791469 18.486986207513954, -101.48146881555535 18.490259820188477, -101.43804315663402 18.49135102441332, -101.41110022956606 18.510628965718844, -101.36957642432013 18.499716923470434, -101.36418783890653 18.51826739529273, -101.28114022841467 18.544638164059727, -101.21267349610078 18.536635999744224, -101.18794939832075 18.517539925809505, -101.08873603158811 18.505900414077868, -101.00949212844702 18.525542090125008, -101.004420518646 18.49135102441332, -100.97557573790264 18.48316699272701, -100.96670042075084 18.453704478656302, -100.92105593254158 18.445520446969994, -100.87382656626949 18.492078493896546, -100.82469534632202 18.474255491557475, -100.79331476067814 18.477165369490386, -100.7758811019871 18.437882017396106, -100.73689310164168 18.42678810777689, -100.71755758927526 18.399508002155862, -100.68776188169421 18.40896510543782, -100.68395817434345 18.386777286199383, -100.64275134471008 18.346220862509455, -100.59076734424953 18.41460299393283, -100.63736275929648 18.457705560814052, -100.74450051634324 18.518085527921926, -100.76478695554735 18.56100622743234, -100.75147397981965 18.633571308384273, -100.76225115064683 18.68031122268163, -100.78412246791378 18.687767784884713, -100.77334529708659 18.732507158103196, -100.79711846802891 18.74669281302613, -100.79046198016506 18.825441384585496, -100.77714900443736 18.85981431766799, -100.748304223694 18.86781648198349, -100.70361066232243 18.824350180360653, -100.70551251599781 18.795615135773172, -100.62246490550595 18.866907145129456, -100.6132726127416 18.886912555918208, -100.5847448076108 18.858177511330727, -100.53878334378896 18.843991856407794))",2023,Total,3604215,3599951,3604215,4264,4264,0.12
2,,15,México,"POLYGON ((-99.859187630451 20.26837710456701, -99.85950460606357 20.26492162452168, -99.84207094737253 20.28183529000672, -99.78850206884916 20.222910261865298, -99.72098626337295 20.167804448510825, -99.69911494610601 20.1725330001518, -99.65980997014803 20.18071703183811, -99.62969728695441 20.145798496643195, -99.51241631030561 20.175079143343098, -99.50512587121662 20.160347886307743, -99.51907279816946 20.148162772463685, -99.48705826130046 20.10506020558246, -99.44109679747862 20.013217183325004, -99.4449005048294 19.985027740849944, -99.47406226118532 19.954292155183587, -99.48388850517482 19.90518796506574, -99.4360251876776 19.903187423986864, -99.4325384559394 19.87517984888261, -99.43000265103888 19.870815031983245, -99.41510479724835 19.850445886452878, -99.37358099200242 19.85153709067772, -99.38784489456782 19.77715333601772, -99.34346830880881 19.780245081321436, -99.27088089353157 19.858629918139187, -99.23633055176207 19.87336117517454, -99.2182629418459 19.88900176906393, -99.21541016133281 19.954474022554393, -99.18941816110254 19.99266617042383, -99.14250577044301 20.027039103506326, -99.11841562388813 20.0290396445852, -99.07086928200347 20.017945734965984, -99.06769952587783 19.985027740849944, -99.0315643060455 20.014853989662267, -99.03441708655856 19.971569555410237, -99.01381367174189 19.981208526063, -99.0055723058152 20.05322800490251, -98.99130840324982 20.067049925083833, -98.96151269566877 20.040861023687647, -98.94661484187824 20.02722097087713, -98.94502996381543 19.97484316808476, -98.99574606182571 19.956838298374883, -98.95263737851697 19.906461036661387, -98.98940654957443 19.881363339490044, -99.02047015960574 19.867723286679528, -98.97038801282056 19.808616391167305, -98.94566391504056 19.803887839526325, -98.91396635378412 19.87699852259068, -98.8705406948628 19.895003392300556, -98.81475298705148 19.867723286679528, -98.79541747468505 19.856265642318697, -98.78051962089452 19.883545747939724, -98.75484459627681 19.876634787849063, -98.7291695716591 19.864995276117426, -98.67179698578495 19.853537631756595, -98.69810596162779 19.83189541463058, -98.6784534736488 19.81407241229151, -98.66101981495777 19.83462342519268, -98.63978244891595 19.810798799616986, -98.59699074121977 19.765695691656887, -98.60808488765952 19.724957400596153, -98.63280898543954 19.72222939003405, -98.6198129853244 19.660940086072145, -98.66482352230854 19.660394483959724, -98.66545747353366 19.606198007459284, -98.6705290833347 19.598559577885396, -98.68130625416188 19.598195843143785, -98.70856615684242 19.55454767415014, -98.65309542464365 19.4657963971964, -98.6350278147275 19.4312415967431, -98.66038586373264 19.432150933597132, -98.65753308321956 19.39705053103141, -98.64485405871699 19.351765555700506, -98.66387259547085 19.324849184821094, -98.63217503421441 19.263741748229993, -98.6277373756385 19.25774012499337, -98.64390313187928 19.23864405105865, -98.64041640014108 19.16717017433156, -98.63914849769083 19.16353282691542, -98.63629571717775 19.153348254150238, -98.62710342441338 19.124613209562757, -98.63914849769083 19.077509560523783, -98.62361669267517 19.066415650904567, -98.6277373756385 19.0222218797985, -98.63280898543954 19.01549278707865, -98.66672537598393 19.001307132155716, -98.71522264470627 18.942563971385106, -98.72631679114602 18.944746379834786, -98.79224771855941 18.93528927655283, -98.79953815764839 18.94038156293542, -98.82426225542841 18.95493095259997, -98.83599035309328 18.950020533588184, -98.84074498728175 18.955658422083197, -98.86863884118742 18.999670325818453, -98.87117464608792 19.025131757731412, -98.90382313418206 19.038408075800312, -98.91555123184693 19.064051375084077, -98.9789463543598 19.07423594784926, -98.95770898831799 19.122430801113076, -98.95517318341749 19.17389926705141, -98.96848615914519 19.210636475954395, -98.94598089065312 19.224822130877328, -98.97672752507185 19.25301157335239, -98.96056176883107 19.325394786933515, -98.97450869578391 19.337034298665152, -98.99194235447494 19.367588016960703, -99.0581902575009 19.40068787844755, -99.05565445260038 19.422148228202758, -99.05121679402448 19.449973935936203, -99.06421279413962 19.49871439131244, -99.09052176998246 19.509262698819235, -99.13077767277814 19.53599720232784, -99.11271006286196 19.573098145972438, -99.11809864827556 19.590557413569897, -99.12380420930171 19.592739822019578, -99.14377367289327 19.57237067648921, -99.1764221609874 19.531996120170092, -99.15740362423354 19.502897340840995, -99.20463299050563 19.514900587314248, -99.21382528326998 19.497077584975177, -99.20685181979357 19.471070550949797, -99.20875367346896 19.46979747935415, -99.23981728350027 19.41214552280838, -99.25598303974105 19.40341588900965, -99.32920440624342 19.35212929044212, -99.35646430892395 19.30320696769508, -99.36533962607575 19.27774553578212, -99.33934762584548 19.267560963016937, -99.32444977205495 19.232460560451216, -99.32223094276699 19.232460560451216, -99.3158914305157 19.227368274068624, -99.31367260122776 19.21900237501151, -99.30701611336391 19.2108183433252, -99.27912225945825 19.131706037024223, -99.29528801569903 19.12261266848388, -99.31398957684033 19.098242440795765, -99.31177074755237 19.02458615561899, -99.31303865000262 18.94801999250931, -99.34188343074598 18.92255856059635, -99.36502265046319 18.89891580239146, -99.42936869981375 18.87763732000706, -99.42683289491323 18.82453204773146, -99.46550391964608 18.759241661611803, -99.46645484648377 18.75360377311679, -99.49434870038944 18.720322044259138, -99.53333670073485 18.694133142862952, -99.57105679863001 18.706863858819432, -99.5808830426195 18.730142882282706, -99.62335777470312 18.73869064871063, -99.63128216501724 18.720322044259138, -99.66139484821085 18.771244908085055, -99.69721309243062 18.786158032491215, -99.70925816570806 18.768880632264565, -99.67217201903804 18.713411084168477, -99.73873689767655 18.737417577114982, -99.77201933699581 18.686494713289065, -99.78596626394864 18.63939106425009, -99.85855367922588 18.612656560741485, -99.88803241119436 18.61884005134892, -99.94286919216799 18.589741272019822, -99.96157075330929 18.55282219574603, -100.02179611969652 18.60374505957195, -100.0680745591309 18.59101434361547, -100.07694987628271 18.548821113588282, -100.08994587639785 18.522086610079675, -100.15936353554945 18.491532891784125, -100.18567251139228 18.45497755025195, -100.22687934102565 18.43078918993464, -100.25794295105696 18.42860678148496, -100.26808617065902 18.3793207239963, -100.29185934160134 18.38168499981679, -100.30612324416674 18.36786307963547, -100.35937514707754 18.423514495102367, -100.38536714730782 18.426424373035275, -100.36191095197806 18.496625178166717, -100.39614431813501 18.540455214531168, -100.42974373306683 18.51099270046046, -100.44939622104582 18.553731532600068, -100.42974373306683 18.59919837530178, -100.47475427005097 18.619021918719724, -100.48679934332841 18.639936666362512, -100.47348636760071 18.69085953018843, -100.44749436737044 18.701589705066034, -100.42213631836529 18.763242743769553, -100.43132861112966 18.783430021929114, -100.48204470913996 18.79870688107689, -100.5020141727315 18.830715538338893, -100.53878334378896 18.843991856407794, -100.5847448076108 18.858177511330727, -100.6132726127416 18.886912555918208, -100.54353797797744 18.9371079502609, -100.52768919734922 19.010400500696058, -100.47919192862688 19.032042717822073, -100.41167612315067 19.06332390560085, -100.40914031825015 19.074963417332487, -100.38980480588373 19.14298181401425, -100.3615939763655 19.154621325745886, -100.37268812280524 19.19299534098613, -100.33813778103574 19.227004539327012, -100.319753195507 19.26174120715112, -100.31785134183161 19.317938224730433, -100.30675719539187 19.32684972589997, -100.31277973203059 19.362313863207305, -100.29344421966417 19.395049989952536, -100.23733953624027 19.40341588900965, -100.19549875538178 19.44615472114926, -100.20088734079538 19.492712768075812, -100.17806509669074 19.492712768075812, -100.20183826763306 19.499259993424857, -100.19676665783204 19.531632385428477, -100.22751329225078 19.557639419453857, -100.2468488046172 19.597468373660554, -100.26523339014594 19.662031290296987, -100.25857690228209 19.700223438166425, -100.19042714558076 19.699495968683195, -100.14985426717251 19.72750354378745, -100.14478265737148 19.764240752690434, -100.13432246215686 19.845353600070286, -100.09184773007324 19.859902989734834, -100.13051875480609 19.91610000731415, -100.13146968164378 19.98175412817542, -100.11593787662812 20.00594248849273, -100.15524285258611 20.00721556008838, -100.15302402329816 20.054319209127353, -100.13780919389507 20.044316503732976, -100.07694987628271 20.029403379326816, -100.04398441257602 20.036496206788282, -100.00024177804214 20.077416365219822, -99.98027231445059 20.05904776076833, -99.92638646031465 20.06414004715092, -99.9419182653303 20.118882125763783, -99.93240899695337 20.17380607174745, -99.96600841188518 20.2016317794809, -99.97773650955007 20.2389145904963, -99.95808402157108 20.25164530645278, -99.95111055809467 20.21581743440383, -99.91941299683823 20.21709050599948, -99.92258275296388 20.231094293551607, -99.93431085062876 20.250190367486326, -99.91339046019951 20.285836372164468, -99.859187630451 20.26837710456701))",2023,Total,17501220,17379644,17501220,121576,121576,0.7
3,,17,Morelos,"POLYGON ((-99.06199396485167 19.0487745159363, -99.02934547675754 19.08514799009767, -98.9789463543598 19.07423594784926, -98.91555123184693 19.064051375084077, -98.90382313418206 19.038408075800312, -98.87117464608792 19.025131757731412, -98.86863884118742 18.999670325818453, -98.84074498728175 18.955658422083197, -98.83599035309328 18.950020533588184, -98.82426225542841 18.95493095259997, -98.79953815764839 18.94038156293542, -98.79224771855941 18.93528927655283, -98.72631679114602 18.944746379834786, -98.71522264470627 18.942563971385106, -98.66672537598393 19.001307132155716, -98.63280898543954 19.01549278707865, -98.64865776606776 19.0009433974141, -98.67781952242368 18.924013499562804, -98.67211396139751 18.87981972845674, -98.68891366886344 18.85799564395992, -98.68891366886344 18.858177511330727, -98.68891366886344 18.85799564395992, -98.69081552253881 18.855449500768625, -98.69525318111472 18.844901193261826, -98.72790166920885 18.80616344327997, -98.74755415718784 18.75815045738696, -98.75357669382656 18.74269173086838, -98.7158565959314 18.739054383452242, -98.74089766932399 18.703772113515715, -98.72790166920885 18.66939918043322, -98.7193433276696 18.605018131167597, -98.71268683980576 18.58519458774965, -98.70793220561728 18.4988075866164, -98.70666430316703 18.444974844857573, -98.72695074237114 18.43951882373337, -98.75484459627681 18.456978091330825, -98.81094927970071 18.519176732146768, -98.84169591411944 18.507173485673516, -98.85025425565868 18.47807470634442, -98.91523425623437 18.45715995870163, -98.93964137840183 18.421877688765104, -98.98560284222366 18.41987714768623, -99.066114647815 18.332580809698943, -99.07086928200347 18.334945085519433, -99.06674859904014 18.368226814377085, -99.12729094103992 18.425696903552048, -99.13933601431737 18.46407091879229, -99.20463299050563 18.455159417622756, -99.26897903985619 18.45315887654388, -99.32825347940572 18.45952423452212, -99.32825347940572 18.488804881222023, -99.35741523576164 18.46770826620843, -99.37928655302858 18.520449803742416, -99.42302918756246 18.562097431657183, -99.41985943143682 18.590286874132243, -99.4537758219812 18.609928550179383, -99.4636020659707 18.642482809553808, -99.4645529928084 18.643755881149456, -99.48071874904917 18.68449417221019, -99.49434870038944 18.720322044259138, -99.46645484648377 18.75360377311679, -99.46550391964608 18.759241661611803, -99.42683289491323 18.82453204773146, -99.42936869981375 18.87763732000706, -99.36502265046319 18.89891580239146, -99.34188343074598 18.92255856059635, -99.31303865000262 18.94801999250931, -99.31177074755237 19.02458615561899, -99.31398957684033 19.098242440795765, -99.29528801569903 19.12261266848388, -99.27912225945825 19.131706037024223, -99.2271382589977 19.09606003234608, -99.13648323380428 19.08933093962623, -99.1355323069666 19.08933093962623, -99.12538908736454 19.062050834005202, -99.06199396485167 19.0487745159363))",2023,Total,2030857,2017078,2030857,13779,13779,0.68
4,,25,Sinaloa,"POLYGON ((-108.47046409698667 27.034570768064903, -108.42164985265177 27.021112582625197, -108.35001336421222 27.022567521591654, -108.33321365674631 27.004562651881773, -108.30373492477783 27.03657130914378, -108.28154663189832 27.012928550938888, -108.25048302186701 27.040936126043142, -108.19469531405569 27.032024624873607, -108.18201628955312 27.00310771291532, -108.23495121685136 26.958550207067642, -108.2301965826629 26.905808669533656, -108.17662770413952 26.88143844184554, -108.14207736237 26.907081741129304, -108.14429619165796 26.867616521664218, -108.09421404487279 26.87052639959713, -108.03715843461121 26.810146432489255, -108.0381093614489 26.769771876170136, -108.0060948245799 26.761042242371406, -108.00672877580503 26.705572694275318, -108.01497014173171 26.685749150857372, -108.08153502037021 26.641737247122116, -108.05173931278917 26.629915868019673, -107.96140126320833 26.526978936142996, -107.95759755585756 26.493697207285344, -107.99975531232862 26.44841223195444, -108.01275131244375 26.438955128672482, -107.90022496998341 26.286732139307155, -107.85616535983696 26.22580657008686, -107.85426350616157 26.196525923386957, -107.78896652997332 26.168518348282703, -107.78104213965922 26.136691558391504, -107.75505013942893 26.134509149941824, -107.73508067583738 26.16815461354109, -107.55567247912596 26.159606847113167, -107.52017121051875 26.10413729901708, -107.46216467341948 26.137419027874735, -107.41652018521022 26.14123824266168, -107.3464685748335 26.109593320141286, -107.30494476958756 26.076311591283634, -107.30684662326294 26.04866775092099, -107.27641696445677 26.001927836623633, -107.29606945243576 25.92481607140153, -107.24281754952494 25.892261812027105, -107.24693823248829 25.878985493958204, -107.19495423202774 25.852069123078792, -107.0583377430125 25.757316222888427, -107.06467725526379 25.71912407501899, -107.01047442551528 25.691480234656346, -106.99050496192373 25.71494112549043, -106.96546388853115 25.697845592634586, -106.96704876659396 25.668383078563878, -106.9943086692745 25.662199587956444, -106.97338827884525 25.62964532858202, -107.13155910951487 25.550351154910235, -107.17023013424772 25.559626390821386, -107.17815452456182 25.515250752344514, -107.14804184136821 25.50506617957933, -107.15564925606975 25.44668675355033, -107.21016906143082 25.417042372108817, -107.17149803669797 25.326290554076202, -107.20826720775544 25.3315647078296, -107.14835881698077 25.258999626877667, -107.12109891430023 25.242449696134244, -107.14867579259334 25.224626693795173, -107.12521959726358 25.186434545925735, -107.12997423145204 25.053125763124317, -107.068163987002 25.030392341773464, -107.01839881582939 24.93363890050422, -106.92710983941086 24.8667117080473, -106.94644535177729 24.858527676360993, -106.93059657114907 24.820881130603976, -106.8859030097775 24.826337151728183, -106.86086193638491 24.81833498741268, -106.70617783745351 24.665202661193316, -106.683989544574 24.598457336107202, -106.63010369043806 24.50643244647894, -106.56670856792519 24.47460565658774, -106.56924437282571 24.436959110830724, -106.60157588530727 24.414589424221482, -106.58604408029161 24.37894341954334, -106.51726037236516 24.286918529915077, -106.50838505521335 24.290919612072827, -106.4697140304805 24.277825161374736, -106.36321022465889 24.304014062770918, -106.32802593166424 24.36112041720427, -106.2687514921147 24.374760470014785, -106.15242144230359 24.338750730595027, -106.07476241722533 24.269277394946812, -106.07000778303686 24.220173204828964, -106.04401578280658 24.22090067431219, -106.00312592878578 24.146880654393804, -105.98981295305808 24.101959413804515, -105.99995617266013 24.045944263596006, -105.9150067084929 23.99956808404026, -105.90866719624161 23.98338188803845, -105.94543636729907 23.947917750731115, -105.8997918790898 23.943916668573365, -105.85795109823131 23.89990476483811, -105.86746036660824 23.875170802408377, -105.95399470883831 23.90845253126603, -105.96128514792728 23.840797869325883, -105.95177587955035 23.81970125431229, -105.92705178177033 23.7615036956541, -105.90613139134109 23.739315876415663, -105.92705178177033 23.68402819569038, -105.90930114746673 23.59018463235405, -105.89281841561339 23.552538086597032, -105.88426007407415 23.59036649972486, -105.81167265879691 23.611099379996837, -105.794872951331 23.580000059588865, -105.76856397548816 23.555084229788328, -105.76032260956148 23.502706426995957, -105.72355343850403 23.475244454004123, -105.73876826790712 23.444690735708573, -105.7007311943994 23.420502375391262, -105.730843877593 23.374853665318746, -105.71816485309043 23.368488307340506, -105.68519938938374 23.28573865362339, -105.64304163291268 23.2753722134874, -105.63004563279755 23.202261530423048, -105.64494348658806 23.14279090016921, -105.59708016909084 23.109145436569943, -105.55492241261979 23.09896086380476, -105.50230446093411 23.127877775763046, -105.41608709431661 23.116965733514636, -105.39231392337427 23.0840477393986, -105.41291733819097 23.07404503400422, -105.4091136308402 23.023667772290725, -105.43256982616995 23.02403150703234, -105.4534902165992 22.97729159273498, -105.50167050970899 22.958377386171065, -105.4712408509028 22.88308429465703, -105.4953309974577 22.81070108107591, -105.50230446093411 22.80997361159268, -105.52322485136335 22.77305453531889, -105.52290787575079 22.72431407994266, -105.49850075358334 22.65138526424911, -105.46426738742639 22.659205561193808, -105.43890933842124 22.587913551837524, -105.44176211893432 22.524441839425933, -105.4668031923269 22.505345765491214, -105.50388933899693 22.526260513134, -105.53400202219055 22.514984736143976, -105.54160943689209 22.53662695326999, -105.59866504715367 22.53662695326999, -105.60088387644163 22.558814772508427, -105.66047529160372 22.58627674550026, -105.68234660887066 22.571909223206518, -105.7007311943994 22.558451037766815, -105.67727499906962 22.5129841950651, -105.67727499906962 22.468062954475812, -105.70168212123708 22.467699219734197, -105.75873773149867 22.537718157494833, -105.81389148808486 22.643928702046033, -105.87094709834645 22.708309751311653, -105.93782895259753 22.769417187902754, -105.99837129459732 22.81288348952559, -106.03450651442965 22.829797155010628, -106.14734983250256 22.962742203070434, -106.25797432128752 23.06840714550921, -106.38317968825044 23.17498142480202, -106.4243865178838 23.179346241701385, -106.42153373737072 23.215355981121142, -106.45323129862716 23.24136301514652, -106.49348720142282 23.30756273812021, -106.48144212814539 23.32665881205493, -106.52867149441747 23.391039861320554, -106.61869256838575 23.473425780296054, -106.62756788553754 23.496886671130138, -106.68272164212375 23.541262309607006, -106.68779325192477 23.560358383541725, -106.81014583837461 23.651655803686765, -106.79556496019666 23.6818457872407, -106.84723198504464 23.74058894801131, -106.86212983883517 23.774416278981384, -106.89319344886647 23.84170720617992, -107.00667071816451 23.94809961810192, -107.11602730449921 24.037214629797276, -107.19400330519004 24.101959413804515, -107.3952828191684 24.225992960694782, -107.47516067353462 24.292192683668475, -107.6656630166858 24.416953700041972, -107.79562301783717 24.48551769883615, -107.82351687174284 24.52243677510994, -107.84443726217208 24.555172901855173, -107.93889599471626 24.60791443938916, -108.00038926355374 24.65392688420329, -108.01845687346992 24.681388857195124, -108.02321150765837 24.736130935807985, -108.0701238983179 24.785053258555028, -108.12179092316589 24.82924702966109, -108.13637180134386 24.871440259688278, -108.23273238756342 25.02657312698652, -108.32750809572015 25.10150248375894, -108.35762077891377 25.169157145699085, -108.38392975475661 25.186434545925735, -108.45049463339512 25.25645348368637, -108.56936048810675 25.31483290971537, -108.65240809859861 25.344113556415273, -108.75162146533125 25.36848378410339, -108.7982168803782 25.36957498832823, -108.91137717406369 25.420679719524955, -109.02675629703711 25.444140610359035, -109.11963015151846 25.544895133786028, -109.16305581043977 25.560899462417034, -109.21947746947623 25.62327997060378, -109.29650254332937 25.645467789842215, -109.39349708077405 25.637283758155906, -109.41124771507766 25.758407427113266, -109.4340699591823 25.809330290939183, -109.42139093467972 25.893898618364368, -109.44769991052256 25.94900443171884, -109.40839493456458 26.058488588944563, -109.31013249466963 26.202527546623585, -109.28667629933987 26.27945744447488, -109.25846546982164 26.320013868164807, -109.20299473762289 26.344384095852924, -109.18904781067005 26.33365392097532, -109.18904781067005 26.333472053604513, -109.18904781067005 26.33365392097532, -109.16527463972773 26.307101284837522, -109.12787151744513 26.298553518409598, -109.12755454183257 26.298553518409598, -109.10029463915204 26.31273917333253, -109.06986498034586 26.35729667918021, -109.00678683344555 26.402399787140308, -108.95004819879654 26.392215214375124, -108.90915834477573 26.41658544206324, -108.88126449087007 26.40621900192725, -108.87650985668161 26.447502895100406, -108.83815580756132 26.47260059227175, -108.9148639058019 26.47951155236241, -108.89140771047212 26.4898779924984, -108.87334010055596 26.5509854290895, -108.77729648994897 26.573718850440358, -108.73418780664021 26.593360526487494, -108.67871707444145 26.586995168509254, -108.67903405005401 26.642828451346958, -108.66350224503836 26.657923443123927, -108.63053678133167 26.67665578231703, -108.62831795204372 26.718303410231798, -108.60137502497575 26.727214911401333, -108.57538302474548 26.79323276700422, -108.53702897562519 26.803053605027788, -108.55699843921674 26.82378648529977, -108.51927834132158 26.87961976813747, -108.46729434086103 26.9707353209117, -108.42450263316485 26.976009474665098, -108.50247863385567 26.987285251655123, -108.47046409698667 27.034570768064903))",2023,Total,3142699,3118470,3142699,24229,24229,0.78
5,,2,Baja California,"MULTIPOLYGON (((-115.21380327868063 28.375115158282163, -115.16752483924624 28.26926834847258, -115.17544922956034 28.210707055072774, -115.15928347331956 28.192702185362897, -115.15643069280648 28.140869984682947, -115.18622640038754 28.10558771474642, -115.18495849793727 28.03211329694045, -115.25469313270143 28.03847865491869, -115.26134962056528 28.06812303636021, -115.3047752794866 28.095948744093654, -115.35390649943407 28.07739827227136, -115.35041976769587 28.116136022253215, -115.31428454786354 28.139233178345684, -115.2416971325863 28.222164699433606, -115.26261752301555 28.292183637194242, -115.24550083993707 28.351290532706468, -115.21380327868063 28.375115158282163)), ((-112.89227389225934 28.678288065417178, -112.85582169681444 28.670831503214096, -112.7566083300818 28.593174135879572, -112.77372501316027 28.578442878844218, -112.80954325738004 28.618817435163336, -112.8659649164165 28.649007418717275, -112.89227389225934 28.678288065417178)), ((-113.52495721493779 29.09549181404808, -113.50245194644572 29.089308323440648, -113.50720658063418 29.041659072289256, -113.52495721493779 29.09549181404808)), ((-113.51386306849803 29.551251445290035, -113.42289106769206 29.49287201926104, -113.38580492102203 29.460135892515808, -113.34459809138866 29.382842259922896, -113.36963916478125 29.353561613222993, -113.36203175007971 29.306821698925635, -113.34333018893841 29.29609152404803, -113.25013935884449 29.282633338608324, -113.17343126060392 29.288453094474143, -113.16931057764059 29.22698192314143, -113.17469916305417 29.12768233868089, -113.14839018721133 29.06621116734818, -113.10020989410155 29.055480992470574, -113.11542472350465 28.987826330530428, -113.18896306561957 29.028200886849547, -113.2491884320068 29.07294026006803, -113.30085545685479 29.14514160627835, -113.40450648216333 29.209340788173165, -113.44888306792234 29.28008719541703, -113.49579545858187 29.28336080809155, -113.57060170314705 29.401574599116003, -113.58866931306322 29.408849293948276, -113.5915220935763 29.45377053453757, -113.56426219089576 29.511058756341725, -113.572820532435 29.537611392479523, -113.51386306849803 29.551251445290035)), ((-118.32650379406255 29.173694783495023, -118.33633003805204 29.151143229514975, -118.31921335497356 29.10640385629649, -118.26088984226172 29.068211708427054, -118.24789384214658 29.01419709929742, -118.24757686653402 28.922354077039962, -118.26596145206275 28.887799276586662, -118.31540964762279 28.872704284809693, -118.30558340363329 28.896892645127004, -118.31826242813587 28.955090203785197, -118.35408067235564 29.042204674401674, -118.39940818495234 29.06857544316867, -118.40004213617748 29.15368937270627, -118.32650379406255 29.173694783495023)), ((-114.74658122576078 31.801860159024756, -114.71393273766665 31.748573019378348, -114.66860522506995 31.718746770566028, -114.64990366392865 31.682009561663044, -114.71741946940486 31.680918357438202, -114.79222571397005 31.730750017039277, -114.7998331286716 31.81240846653155, -114.74658122576078 31.801860159024756)), ((-116.69122660884307 32.57097727016691, -115.87945206506576 32.63608578891576, -114.71963829869281 32.71865357526207, -114.80205195795955 32.5867997314271, -114.81346308001186 32.493683637573994, -114.84896434861906 32.47331449204363, -114.88700142212679 32.49168309649512, -114.93961937381248 32.474223828897664, -114.93232893472349 32.438395956848716, -114.9687811301684 32.39092857306813, -114.96244161791711 32.351827088344656, -115.02520278920484 32.28981031489952, -115.0530966431105 32.245070941681035, -114.97575459364481 32.17778001448251, -114.98970152059763 32.14631695933292, -114.95705303250351 32.03846960844446, -114.96751322771813 31.9970038479005, -114.96592834965531 31.918255276341135, -114.91109156868168 31.867514279886024, -114.8407229826924 31.859875850312136, -114.806806592148 31.8164095486893, -114.81694981175006 31.728567608589593, -114.78937293345697 31.672006856268666, -114.79032386029466 31.616719175543388, -114.83279859237828 31.57852702767395, -114.8575226901583 31.502870201418297, -114.85974151944626 31.42921391624153, -114.88002795865037 31.39265857470935, -114.88256376355089 31.253166301300503, -114.89080512947756 31.152775512615122, -114.8673489341478 31.090213137057567, -114.8121951775616 31.04401882487263, -114.83501742166624 31.004553605407544, -114.81251215317417 30.97927404086539, -114.72185712798077 30.936898943467398, -114.70410649367716 30.865606934111113, -114.69618210336306 30.817230213476492, -114.70505742051485 30.7164756900495, -114.6993518594887 30.635908444782068, -114.65243946882917 30.5571598732227, -114.63405488330044 30.501144723014193, -114.63120210278736 30.419668140892725, -114.65624317617994 30.27872092851742, -114.64071137116429 30.25780618087463, -114.66892220068252 30.198335550620794, -114.58270483406501 30.0683003804939, -114.56495419976142 30.009920954464903, -114.53452454095523 29.968091459179327, -114.49109888203392 29.951177793694292, -114.47366522334288 29.916259258499377, -114.41375683256821 29.891161561328033, -114.41534171063104 29.85715236298715, -114.3880818079505 29.7787675261694, -114.33736570994022 29.743848990974485, -114.29710980714454 29.741666582524804, -114.27175175813939 29.772220300820354, -114.2102584893019 29.744940195199327, -114.15954239129161 29.6911074534405, -114.07269107344898 29.6352741706028, -114.04733302444383 29.59708202273336, -113.99534902398328 29.57798594879864, -113.94082921862221 29.522698268073363, -113.83210658351264 29.435583797456882, -113.77568492447618 29.41139543713957, -113.69517311888484 29.3244628338939, -113.63748355739813 29.283178940720745, -113.62512150850812 29.252625222425195, -113.65681906976455 29.216433615634635, -113.64287214281173 29.18424309100182, -113.56711497140884 29.10822253000456, -113.53763623944036 29.036384918535855, -113.56077545915755 29.023654202579376, -113.5452436541419 28.963274235471502, -113.55697175180678 28.94508749839082, -113.51291214166034 28.88907234818231, -113.48311643407929 28.892891562969254, -113.48026365356621 28.947269906840503, -113.42510989698002 28.9498160500318, -113.41686853105334 28.923990883377225, -113.36805428671843 28.903258003105243, -113.37122404284408 28.838513219098008, -113.34713389628918 28.799593601745343, -113.32462862779711 28.799957336486955, -113.25964862722142 28.84015002543527, -113.23365662699115 28.83487587168187, -113.19625350470855 28.791955172171456, -113.19466862664574 28.744851523132482, -113.15536365068775 28.655372776695515, -113.12810374800722 28.628820140557714, -113.12873769923235 28.593174135879572, -113.10433057706489 28.506059665263095, -113.01652833238457 28.457682944628473, -112.98387984429044 28.454773066695562, -112.90431896553679 28.474596610113508, -112.87103652621754 28.43203964534471, -112.84662940405008 28.440951146514244, -112.84948218456316 28.382026118372824, -112.86913467254215 28.33674114304192, -112.87357233111804 28.28199906442906, -112.78640403766285 28.19615766540823, -112.81207906228056 28.135777698300355, -112.78893984256337 28.067213699506176, -112.80510559880415 28.02702101055786, -112.76484969600847 27.99992277230764, -113.20005721205932 27.99992277230764, -113.85841555935548 27.99992277230764, -114.20486990388831 27.99992277230764, -114.14020687892518 28.081035619687494, -114.08251731743847 28.16724075344994, -114.0609629757841 28.214162535118106, -114.08156639060078 28.247626131346564, -114.12372414707184 28.257810704111748, -114.06032902455897 28.395666171183336, -114.04479721954331 28.458774148853315, -114.06952131732334 28.515153033803436, -114.11675068359543 28.558801202797078, -114.16207819619213 28.57025884715791, -114.1639800498675 28.64045965228935, -114.18394951345907 28.657009583032774, -114.27048385568914 28.66010132833649, -114.269849904464 28.689563842407203, -114.31517741706071 28.726301051310184, -114.346241027092 28.730484000838743, -114.34243731974124 28.75521796326847, -114.37730463712332 28.814688593522312, -114.39949293000282 28.82159955361297, -114.40868522276719 28.868703202651943, -114.4885630771334 28.93290238454676, -114.5338905897301 28.924900220231258, -114.54593566300755 28.951270988998253, -114.60108941959375 28.986189524193165, -114.60806288307016 29.059118339886712, -114.63627371258839 29.098037957239377, -114.71615156695461 29.11040493845424, -114.74531332331053 29.18315188677698, -114.81187820194904 29.212978135589303, -114.86386220240959 29.275722378517663, -114.95071352025222 29.361563777538496, -115.08099049701617 29.418306397230232, -115.19129801018856 29.43049151107429, -115.2363085471727 29.500874183576542, -115.29970366968557 29.54124873989566, -115.37894757282666 29.558344272751505, -115.4461464026903 29.618724239859375, -115.50605479346497 29.617087433522116, -115.59005333079452 29.69510853559825, -115.61889811153787 29.695290402969057, -115.69972689274178 29.75512476796451, -115.68451206333869 29.826416777320794, -115.70194572202973 29.899709327755954, -115.74410347850079 29.94826791576138, -115.81193625958956 29.953542069514782, -115.78214055200851 30.093216210294436, -115.80274396682519 30.151959371065047, -115.79513655212365 30.19469820320466, -115.80274396682519 30.279994000113067, -115.83412455246906 30.3392827629961, -115.90956474825938 30.397844056395904, -115.95140552911788 30.403845679632532, -116.00687626131663 30.36619913387551, -116.01638552969357 30.42912524417468, -116.04744913972488 30.470409137347836, -116.02652874929562 30.647547956513705, -116.04713216411231 30.718658098499183, -116.05156982268821 30.780674871944314, -116.07090533505463 30.81450220291439, -116.10830845733723 30.824323040937955, -116.14222484788161 30.855240493975124, -116.17709216526369 30.863242658290623, -116.26743021484452 30.965088385942458, -116.31941421530509 30.955995017402117, -116.33938367889664 30.97818283664055, -116.31085587376585 31.10803613939664, -116.30895402009045 31.150593104165438, -116.3939034842577 31.284447489079277, -116.45381187503237 31.329004994926954, -116.48741128996419 31.3701070207293, -116.50040729007932 31.410481577048422, -116.57077587606861 31.465041788290478, -116.60310738855017 31.463950584065635, -116.60849597396377 31.497050445552482, -116.64621607185893 31.51505531526236, -116.6899587063928 31.571252332841674, -116.65033675482226 31.58598358987703, -116.66808738912587 31.617628512397417, -116.65033675482226 31.66436842669478, -116.73306738970156 31.749846090973996, -116.66301577932484 31.718746770566028, -116.64272934012072 31.734932966567833, -116.60944690080146 31.815863946576883, -116.62719753510507 31.860603319795366, -116.66903831596356 31.861512656649403, -116.69756612109435 31.893703181282213, -116.74669734104182 31.902432815080942, -116.76444797534543 31.966268262234145, -116.85161626880063 31.988092346730966, -116.88141197638167 32.02064660610539, -116.88426475689475 32.089392472270376, -116.88680056179527 32.12340167061126, -116.92325275724016 32.22779354145439, -116.94290524521915 32.24598027853507, -117.02468495326076 32.26871369988593, -117.09568749047517 32.41329825967737, -117.12421529560596 32.48622707537091, -117.12358134438084 32.53424006126392, -116.69122660884307 32.57097727016691)))",2023,Total,4010510,3948201,4010510,62309,62309,1.58
6,,26,Sonora,"MULTIPOLYGON (((-112.55437788926575 28.73102960295116, -112.55532881610344 28.672104574809744, -112.60255818237553 28.673741381147003, -112.61301837759015 28.726846653422605, -112.55437788926575 28.73102960295116)), ((-112.29223905767503 29.226254453658203, -112.26244335009397 29.193700194283778, -112.27480539898399 29.13768504407527, -112.223138374136 29.06966664739351, -112.20253495931932 29.01492456878065, -112.23962110598934 28.87179494795566, -112.2719526184709 28.824691298916687, -112.27702422827194 28.769403618191404, -112.30967271636607 28.747033931582166, -112.36102276560149 28.761401453875905, -112.40222959523486 28.795956254329205, -112.45801730304619 28.801957877565833, -112.46879447387337 28.818689675680062, -112.5841735968468 28.87634163222583, -112.51380501085751 28.9179892601406, -112.48939788869005 28.94908858054857, -112.5058806205434 29.013833364555808, -112.47766979102518 29.167875027629208, -112.44914198589439 29.199883684891212, -112.41173886361179 29.18551616259747, -112.3600718387638 29.22025283042158, -112.29223905767503 29.226254453658203)), ((-114.67589566415893 31.756211448952236, -114.602357322044 31.753119703648522, -114.61598727338428 31.72784013910637, -114.67589566415893 31.756211448952236)), ((-114.81346308001186 32.493683637573994, -113.57662423978577 32.11503577155414, -113.43683799464489 32.07120573518969, -113.21020043166138 31.999731858462603, -112.34549096058583 31.734751099197027, -112.12012130005259 31.664550294065585, -111.6567029544835 31.51851079530769, -111.21420499934368 31.37719984819077, -111.0753696810405 31.332642342343092, -110.701021482602 31.333006077084704, -110.33966928427864 31.33318794445551, -109.74692488878331 31.33391541393874, -108.9716025404509 31.33227860760148, -108.75605912390715 31.332460474972287, -108.81723541713207 31.238798779006757, -108.87999658841981 31.23861691163595, -108.90028302762393 31.20242530484539, -108.86097805166595 31.218975235588815, -108.84829902716338 31.19496874264231, -108.80487336824206 31.192786334192625, -108.84576322226286 31.135316245017663, -108.77032302647255 31.102216383530816, -108.7662023435092 31.073663206314144, -108.73450478225277 31.053475928154583, -108.75257239216894 31.033834252107447, -108.68473961108018 31.033470517365828, -108.68410565985505 31.006008544373998, -108.80328849017924 31.00473547277835, -108.80265453895412 30.903980949351357, -108.93927102796934 30.907618296767495, -108.93134663765524 30.866334403594337, -108.93546732061857 30.77358204448285, -108.94814634512115 30.736844835579866, -108.91898458876523 30.739390978771162, -108.86731756391724 30.68937745179928, -108.87397405178109 30.623359596196394, -108.83086536847235 30.60171737907038, -108.72753131877636 30.58025702931517, -108.67808312321633 30.5571598732227, -108.6622343425881 30.521695735915365, -108.66508712310119 30.468226728898152, -108.60422780548883 30.46513498359444, -108.61373707386576 30.43567246952373, -108.6489213668604 30.416940130330623, -108.62007658611705 30.374746900303435, -108.62197843979243 30.34037396722094, -108.58013765893394 30.337464089288034, -108.54210058542621 30.28326761278759, -108.55065892696545 30.266717682044167, -108.62039356172961 30.298180737193753, -108.61754078121653 30.23598209637781, -108.61088429335268 30.042111479097713, -108.61563892754114 29.965727183358837, -108.62863492765628 29.953360202143973, -108.61563892754114 29.883523131754146, -108.60739756161448 29.846967790221967, -108.634657464295 29.832054665815807, -108.62990283010654 29.806229499161233, -108.54114965858852 29.79604492639605, -108.54083268297596 29.73602869402979, -108.59249970782395 29.717660089578303, -108.65938156207503 29.716205150611845, -108.61817473244166 29.66055373514495, -108.6552608791117 29.649277958154926, -108.63877814725835 29.558344272751505, -108.66255131820067 29.544522352570183, -108.64384975705937 29.48868906973248, -108.71770507478686 29.465773781010817, -108.66984175728965 29.307367301038056, -108.68220380617966 29.267356479460553, -108.73038409928944 29.269175153168618, -108.74559892869253 29.16223713913419, -108.72911619683919 29.171876109786957, -108.698686538033 29.12768233868089, -108.72975014806431 29.096583018272923, -108.69805258680788 28.936175997221284, -108.70661092834712 28.88398006179972, -108.68822634281838 28.87634163222583, -108.64321580583425 28.765038801292043, -108.5839413662847 28.739941104120696, -108.5839413662847 28.716298345915806, -108.58013765893394 28.632457487973852, -108.55160985380314 28.57771540936099, -108.53132341459903 28.556618794347397, -108.52339902428491 28.505877797892285, -108.50501443875619 28.493328949306616, -108.51547463397081 28.42603802210808, -108.4799733653636 28.369477269787154, -108.52149717060954 28.36493058551698, -108.51959531693414 28.334740601963045, -108.55097590257802 28.317826936478006, -108.60391082987627 28.347471317919524, -108.6365593179704 28.335286204075466, -108.64131395215885 28.291638035081824, -108.68759239159326 28.303459414184267, -108.75130448971869 28.27163262429307, -108.96145932084885 28.261993653640307, -108.98713434546656 28.277816114900503, -108.99886244313144 28.255264560920452, -109.02295258968634 28.277452380158888, -109.07525356575945 28.272541961147105, -109.06574429738252 28.182517612597714, -109.06796312667048 28.128321136097274, -109.03182790683813 28.018109509388324, -108.97857600392733 27.978826157294048, -108.92659200346677 27.94063400942461, -108.91961853999035 27.87097880640559, -108.8695363932052 27.839333883885196, -108.91042624722598 27.80896203296045, -108.91549785702702 27.7756803041028, -108.89584536904803 27.744762851065637, -108.83308419776029 27.744399116324022, -108.76588536789664 27.705661366342163, -108.73989336766637 27.599996423903388, -108.71326741621097 27.566169092933315, -108.65557785472426 27.543617538953264, -108.66191736697554 27.464505232652286, -108.63370653745731 27.42813175849092, -108.62958585449398 27.382846783160012, -108.5912318053737 27.317920131781968, -108.66477014748862 27.239353427593414, -108.64416673267193 27.17879159311473, -108.61151824457781 27.154057630685003, -108.59725434201242 27.07676399809209, -108.60232595181344 27.036935043885393, -108.5627040002429 27.046028412425734, -108.5725302442324 27.012746683568082, -108.50247863385567 26.987285251655123, -108.42450263316485 26.976009474665098, -108.46729434086103 26.9707353209117, -108.51927834132158 26.87961976813747, -108.55699843921674 26.82378648529977, -108.53702897562519 26.803053605027788, -108.57538302474548 26.79323276700422, -108.60137502497575 26.727214911401333, -108.62831795204372 26.718303410231798, -108.63053678133167 26.67665578231703, -108.66350224503836 26.657923443123927, -108.67903405005401 26.642828451346958, -108.67871707444145 26.586995168509254, -108.73418780664021 26.593360526487494, -108.77729648994897 26.573718850440358, -108.87334010055596 26.5509854290895, -108.89140771047212 26.4898779924984, -108.9148639058019 26.47951155236241, -108.83815580756132 26.47260059227175, -108.87650985668161 26.447502895100406, -108.88126449087007 26.40621900192725, -108.90915834477573 26.41658544206324, -108.95004819879654 26.392215214375124, -109.00678683344555 26.402399787140308, -109.06986498034586 26.35729667918021, -109.10029463915204 26.31273917333253, -109.12755454183257 26.298553518409598, -109.12787151744513 26.298553518409598, -109.16527463972773 26.307101284837522, -109.18904781067005 26.33365392097532, -109.18904781067005 26.333472053604513, -109.18904781067005 26.33365392097532, -109.20299473762289 26.344384095852924, -109.25846546982164 26.320013868164807, -109.25466176247087 26.446047956133953, -109.26448800646037 26.491332931464854, -109.31425317763298 26.569172166170183, -109.35831278777941 26.599362149724122, -109.41568537365356 26.661924525281677, -109.49524625240721 26.67029042433879, -109.56434693594625 26.690113967756737, -109.63376459509783 26.69520625413933, -109.68669952239608 26.675928312833804, -109.77355084023871 26.71066498065791, -109.83472713346363 26.766861998237225, -109.85533054828032 26.801053063948913, -109.88512625586137 26.90562680216285, -109.94313279296064 26.989467660104808, -109.939963036835 27.009109336151944, -109.94186489051039 27.01802083732148, -109.98497357381913 27.06403328213561, -110.08925855035281 27.10222543000505, -110.2173166978288 27.13387035252544, -110.28831923504322 27.148056007448375, -110.33237884518967 27.172244367765686, -110.4040153336292 27.243718244492776, -110.47216509033053 27.28445653555351, -110.53556021284341 27.285729607149158, -110.60180811586936 27.316465192815514, -110.58786118891652 27.516519300703045, -110.62463035997399 27.609453527185345, -110.60117416464423 27.700387212588765, -110.61638899404731 27.77913578414813, -110.58659328646627 27.830604250086466, -110.52066235905288 27.842425629188913, -110.59134792065473 27.88480072658691, -110.63128684783784 27.882254583395614, -110.81196294699951 27.924265946051992, -110.82749475201517 27.954274062235122, -110.89057289891548 27.92044673126505, -110.90705563076882 27.892984758273215, -110.85665650837109 27.901350657330333, -110.88423338666419 27.839515751256002, -110.96220938735502 27.904442402634047, -110.98027699727119 27.955910868572385, -111.02211777812968 27.963185563404657, -111.06490948582586 27.939542805199768, -111.14161758406644 27.98610085212632, -111.17585095022339 27.994466751183438, -111.21198617005572 28.041934134964023, -111.27760012185655 28.081035619687494, -111.28489056094553 28.11358987906192, -111.3295841223171 28.15960232387605, -111.33433875650557 28.195248328554193, -111.37427768368867 28.216890545680208, -111.38600578135356 28.256901367257715, -111.45732529418054 28.31709946699478, -111.46239690398157 28.3654761876294, -111.49219261156261 28.387118404755416, -111.58221368553089 28.41512597985967, -111.6452918324312 28.443679157076346, -111.71249066229484 28.45895601622412, -111.76510861398052 28.593356003250378, -111.80156080942541 28.629365742670135, -111.86939359051419 28.671377105326517, -111.92549827393808 28.71902635647791, -111.95053934733066 28.757764106459767, -111.90140812738319 28.78704475315967, -111.98604061593787 28.849607128717224, -112.03136812853457 28.859427966740796, -112.04785086038791 28.899256920947494, -112.11314783657618 28.960909959651016, -112.17369017857597 28.970730797674584, -112.15086793447134 28.988553800013655, -112.1679846175498 29.024745406804218, -112.16513183703672 29.114951622724412, -112.20316891054445 29.17860520250681, -112.23011183761241 29.180423876214878, -112.20919144718317 29.24153131280598, -112.24120598405217 29.316824404320013, -112.28653349664887 29.332101263467788, -112.34105330200994 29.31809747591566, -112.40222959523486 29.336829815108764, -112.42093115637616 29.37465822823659, -112.38257710725587 29.448678248154977, -112.37845642429254 29.48068690541698, -112.42885554669026 29.51978839014045, -112.43709691261694 29.561072283313607, -112.50746549860622 29.62127038305067, -112.52616705974752 29.665646021527543, -112.58005291388346 29.710930996858448, -112.60858071901426 29.782041138843923, -112.651689402323 29.834600809007103, -112.66563632927583 29.89170716344045, -112.74741603731744 29.915349921645344, -112.73315213475203 30.000463851182946, -112.7610459886577 30.06011634880759, -112.75407252518129 30.17778453771962, -112.77626081806079 30.225797523612627, -112.82412413555801 30.267081416785782, -112.86216120906573 30.269263825235463, -112.84694637966264 30.304546095171993, -112.85328589191393 30.384567738327004, -112.86913467254215 30.422032416713215, -112.94489184394503 30.504963937801136, -112.98768355164121 30.5358813908383, -113.07611974754667 30.664279754627934, -113.12715282116953 30.81050112075664, -113.10084384532668 30.89161396813649, -113.09672316236335 30.951266465761137, -113.09957594287643 30.985821266214437, -113.12842072361978 31.05875008190798, -113.09228550378745 30.995096502125584, -113.06217282059383 31.033288649995022, -113.05900306446819 31.072390134718496, -113.10179477216438 31.189512721518106, -113.18928004123214 31.22279445037576, -113.20734765114831 31.24061745271483, -113.25552794425809 31.24061745271483, -113.35347340854047 31.264987680402946, -113.54651155659216 31.29663260292334, -113.56109243477012 31.318638554790965, -113.62417058167043 31.3275500559605, -113.60990667910502 31.36847021439204, -113.63748355739813 31.43521553947815, -113.64065331352377 31.48050051480906, -113.68883360663355 31.519238264790914, -113.80421272960697 31.564886974863434, -113.85239302271675 31.595440693158984, -113.93987829178451 31.605261531182556, -113.97981721896763 31.631268565207932, -113.9737946823289 31.578345160303144, -113.95604404802529 31.562158964301332, -114.00612619481046 31.52378494906109, -114.02577868278945 31.49195815916989, -114.14781429362672 31.494140567619574, -114.20708873317626 31.51378224366671, -114.30027956327018 31.561249627447296, -114.3383166367779 31.60035111217077, -114.49204980887161 31.675644203684804, -114.55417702893422 31.735478568680257, -114.61947400512248 31.76275867430128, -114.67811449344688 31.76003066373918, -114.72280805481846 31.776944329224214, -114.75704142097541 31.816227681318495, -114.806806592148 31.8164095486893, -114.8407229826924 31.859875850312136, -114.91109156868168 31.867514279886024, -114.96592834965531 31.918255276341135, -114.96751322771813 31.9970038479005, -114.95705303250351 32.03846960844446, -114.98970152059763 32.14631695933292, -114.97575459364481 32.17778001448251, -115.0530966431105 32.245070941681035, -115.02520278920484 32.28981031489952, -114.96244161791711 32.351827088344656, -114.9687811301684 32.39092857306813, -114.93232893472349 32.438395956848716, -114.93961937381248 32.474223828897664, -114.88700142212679 32.49168309649512, -114.84896434861906 32.47331449204363, -114.81346308001186 32.493683637573994)))",2023,Total,3081734,3051188,3081734,30546,30546,1.0
7,,3,Baja California Sur,"MULTIPOLYGON (((-109.80049376730668 24.151972940776396, -109.8020786453695 24.137605418482657, -109.87371513380904 24.153791614484465, -109.92284635375653 24.262184567485345, -109.91840869518062 24.291101479443633, -109.93964606122243 24.324383208301285, -109.93077074407063 24.375851674239623, -109.80049376730668 24.151972940776396)), ((-110.3542501624566 24.531348276279477, -110.2892701618809 24.473332584992093, -110.3079717230222 24.42495586435747, -110.34886157704301 24.401313106152582, -110.34695972336762 24.43132122233571, -110.37865728462405 24.447871153079134, -110.39767582137792 24.51043352863669, -110.3542501624566 24.531348276279477)), ((-110.39133630912663 24.590273304420897, -110.36217455277071 24.554991034484367, -110.41130577271818 24.572632169452632, -110.39133630912663 24.590273304420897)), ((-110.70704401924073 25.10477609643346, -110.66868997012044 25.05185269152867, -110.60244206709449 25.03857637345977, -110.57486518880138 25.015661084738106, -110.57106148145061 24.956917923967495, -110.5266848956916 24.881079230341044, -110.58310655472806 24.8667117080473, -110.5739142619637 24.888172057802507, -110.65379211632991 24.946005881719085, -110.68136899462301 25.02020776900828, -110.71243260465431 25.03002860703185, -110.70704401924073 25.10477609643346)), ((-110.6877085068743 25.30555767380422, -110.70609309240302 25.267911128047203, -110.73145114140817 25.282278650340942, -110.6877085068743 25.30555767380422)), ((-110.77360889787923 25.7114856454451, -110.7596619709264 25.592908119679038, -110.80403855668541 25.640375503459623, -110.79991787372208 25.683478070340847, -110.77360889787923 25.7114856454451)), ((-111.03511377824482 25.714213656007203, -111.01419338781558 25.669110548047104, -111.04715885152227 25.664200129035322, -111.05952090041228 25.70857576751219, -111.03511377824482 25.714213656007203)), ((-111.0601548516374 26.071037437530237, -111.08075826645408 26.0328452896608, -111.06744529072638 25.96573622983307, -111.10611631545923 25.998836091319916, -111.17997163318672 25.905538130096005, -111.1828244136998 25.86643664537253, -111.20406177974162 25.848977377775075, -111.20184295045367 25.80823908671434, -111.22878587752164 25.822606609008083, -111.20913338954264 25.92990835778412, -111.16824353552185 25.98883338592554, -111.17553397461083 26.041756790830334, -111.12767065711361 26.066672620630868, -111.10579933984667 26.053032567820356, -111.0601548516374 26.071037437530237)), ((-112.08049934848205 27.25099293932505, -112.04341320181202 27.208072239814634, -112.05926198244023 27.179700929968767, -112.08525398267051 27.18643002268862, -112.10871017800027 27.239353427593414, -112.08049934848205 27.25099293932505)), ((-111.9448337863045 27.434497116469156, -111.92866803006372 27.41067249089346, -111.96385232305836 27.41467357305121, -111.9448337863045 27.434497116469156)), ((-115.19319986386395 27.885346328699328, -115.15864952209444 27.864249713685734, -115.17386435149753 27.849336589279574, -115.19319986386395 27.885346328699328)), ((-111.56161027071421 26.55571398073048, -111.45066880631668 26.516612496007006, -111.47254012358363 26.456414396269942, -111.46937036745798 26.413311829388718, -111.39583202534305 26.339473676841138, -111.38346997645304 26.28054864869972, -111.39583202534305 26.250904267258207, -111.34511592733276 26.112321330703388, -111.31912392710248 26.07685719339605, -111.34574987855788 26.026116196940944, -111.33560665895583 26.002837173477666, -111.35684402499764 25.96810050565356, -111.33687456140608 25.908266140658107, -111.33243690283018 25.83479172285214, -111.3162711465894 25.836792263931017, -111.30390909769939 25.770592540957324, -111.22593309700856 25.726035035109646, -111.19423553575213 25.614914071546664, -111.11562558383616 25.525071590368082, -111.01672919271608 25.5148870176029, -111.02718938793072 25.451051570449696, -111.00405016821351 25.416496769996396, -110.97996002165863 25.341385545853168, -110.93399855783679 25.29100828413967, -110.94509270427655 25.252088666787007, -110.92068558210909 25.202984476669158, -110.90768958199395 25.145514387494195, -110.86996948409879 25.102775555354587, -110.81227992261208 25.032029148110723, -110.76092987337665 25.014751747884073, -110.74983572693691 24.96582942513703, -110.68548967758635 24.88398910827395, -110.65727884806812 24.807241077793464, -110.69404801912559 24.70175800272549, -110.7276474340574 24.672841090767204, -110.74032645855998 24.620099553233217, -110.72986626334536 24.51516208027767, -110.6867575800366 24.46187494063126, -110.69309709228789 24.40549605568114, -110.67724831165967 24.35075397706828, -110.64111309182734 24.31547170713175, -110.60783065250808 24.252181862090968, -110.55267689592188 24.207988090984905, -110.3986267482156 24.173797025273217, -110.30290011322117 24.1812535874763, -110.30702079618452 24.234540727122706, -110.336499528153 24.257637883215175, -110.3399862598912 24.314562370277716, -110.29782850342015 24.352208916034733, -110.23443338090728 24.344206751719234, -110.2369691858078 24.319109054547887, -110.19354352688647 24.293283887893317, -110.17484196574517 24.25272746420339, -110.07848137952561 24.209261162580553, -110.00811279353633 24.159429502979478, -109.98814332994478 24.048672274158108, -109.9301367928455 24.028484995998546, -109.8287045968249 24.061584857485393, -109.80461445027002 24.020664699053853, -109.83916479203953 23.97192424367762, -109.82141415773593 23.908270663895223, -109.77386781585128 23.876080139262413, -109.69969552251122 23.798240904557083, -109.71300849823892 23.733132385808233, -109.69779366883583 23.6712974797339, -109.68765044923377 23.652201405799183, -109.51838547212441 23.58272807015097, -109.46862030095181 23.5543567603051, -109.48034839861668 23.528531593650527, -109.46101288625026 23.48742956784818, -109.42519464203049 23.450328624203586, -109.4321681055069 23.42122984487449, -109.41378351997818 23.38903932024168, -109.4321681055069 23.377036073768426, -109.42519464203049 23.306107799153757, -109.45562430083667 23.20153406093982, -109.53296635030237 23.11223718187366, -109.57670898483626 23.0840477393986, -109.66894888809247 23.0602231138229, -109.71395942507661 23.03039686501058, -109.73171005938022 22.990931645545494, -109.79003357209206 22.967652622082216, -109.80905210884592 22.933643423741337, -109.85406264583006 22.899270490658843, -109.9025599145524 22.889267785264465, -109.8946355242383 22.87580959982476, -109.96373620777732 22.871990385037815, -110.01857298875096 22.905635848637083, -110.05185542807021 22.942554924910873, -110.0990847943423 23.01930295539136, -110.1203221603841 23.114237722952534, -110.15392157531593 23.22972350341488, -110.15931016072952 23.286647990477423, -110.26327816165063 23.476153790858156, -110.30765474740964 23.538170564303293, -110.37326869921046 23.592912642916154, -110.55172596908419 23.67038814287987, -110.5995892865814 23.698941320096544, -110.68295387268583 23.76823278837395, -110.82337406905184 23.91718216506476, -111.01894802200404 24.090865504185295, -111.12196509608745 24.157247094529794, -111.24748743866293 24.228539103886078, -111.40280548881947 24.308560747041092, -111.53086363629546 24.358574274012973, -111.58411553920628 24.368395112036545, -111.69442305237867 24.35075397706828, -111.71312461351997 24.310379420749157, -111.75116168702769 24.351845181293122, -111.94071310334117 24.484426494611313, -112.10205369013642 24.55881024927131, -112.10427251942437 24.58299860958862, -112.17495808102622 24.653199414720063, -112.13628705629337 24.68466246986965, -112.14009076364414 24.727037567267644, -112.1812975932775 24.770322001519673, -112.23550042302601 24.789781810196004, -112.27322052092117 24.771776940486127, -112.30269925288965 24.791782351274883, -112.2792430575599 24.83106570336916, -112.19904822758112 25.034393423931213, -112.15403769059698 25.187162015408965, -112.13723798313106 25.297555509488717, -112.11568364147669 25.362300293495956, -112.09761603156052 25.488516248835907, -112.10078578768616 25.74949592594373, -112.12963056842952 25.815331914175808, -112.19207476410469 25.987378446959084, -112.2320136912878 26.034482095998058, -112.30872178952838 26.072128641755075, -112.31094061881633 26.099408747376103, -112.34485700936071 26.178702921047886, -112.40761818064846 26.244357041909158, -112.4729151568367 26.259088298944512, -112.49795623022929 26.231444458581873, -112.65390823161096 26.325288021918205, -112.67990023184123 26.316012786007057, -112.71191476871023 26.35729667918021, -112.78703798888797 26.405855267185636, -112.86945164815471 26.470600051192875, -112.97817428326428 26.53370802886285, -113.0659765279446 26.606091242443973, -113.12525096749414 26.63682682811033, -113.13824696760928 26.659560249461187, -113.19974023644676 26.68993210038593, -113.26376931018476 26.700116673151115, -113.28310482255118 26.753221945426713, -113.37217496968177 26.798688788128423, -113.46092814119979 26.809237095635222, -113.51069331237238 26.790141021700503, -113.54746248342985 26.720667686052288, -113.57694121539834 26.704663357421285, -113.63843448423582 26.729579187221823, -113.68027526509431 26.776682836260797, -113.73384414361769 26.799416257611654, -113.77917165621439 26.90799107798334, -113.82988775422469 26.956185931247152, -113.87458131559626 26.980738026306078, -113.9471687308735 26.99947036549918, -114.00295643868482 26.97255399461977, -114.05303858546999 27.021658184737618, -114.06223087823436 27.052393770403974, -114.13038063493569 27.11495614596153, -114.18775322080984 27.140417577874487, -114.27492151426503 27.14951094641483, -114.29425702663146 27.127504994547202, -114.38744785672537 27.181337736306027, -114.43499419861003 27.177518521519083, -114.43214141809695 27.20661730084818, -114.48824610152084 27.228441385345, -114.48697819907058 27.336288736233463, -114.5072646382747 27.4090356845562, -114.57382951691321 27.45050144510016, -114.59570083418015 27.475599142271506, -114.66606942016944 27.505607258454635, -114.73833985983411 27.52488519976016, -114.77732786017953 27.59872335230774, -114.81156122633648 27.626549060041185, -114.86100942189651 27.6269127947828, -114.87146961711113 27.649828083504463, -114.93074405666067 27.67601698490065, -114.94120425187529 27.706388835825393, -114.98621478885943 27.728576655063826, -115.00016171581227 27.71693714333219, -115.03407810635665 27.761130914438255, -115.05690035046128 27.822783953141773, -115.08225839946643 27.84788165031312, -115.05594942362359 27.861521703123632, -115.01505956960278 27.831331719569697, -114.92440454440938 27.8340597301318, -114.85340200719497 27.826603167928717, -114.838821129017 27.810053237185294, -114.73770590860899 27.80859829821884, -114.69332932284998 27.78677421372202, -114.60521010255708 27.77349789565312, -114.53357361411754 27.785864876867983, -114.5018760528611 27.771861089315856, -114.4432355645367 27.796049449633166, -114.33039224646379 27.871160673776394, -114.29489097785658 27.864067846314928, -114.26572922150066 27.888438074003044, -114.2654122458881 27.94245268313268, -114.20486990388831 27.99992277230764, -113.85841555935548 27.99992277230764, -113.20005721205932 27.99992277230764, -112.76484969600847 27.99992277230764, -112.75692530569437 27.9642767676295, -112.7718231594849 27.862067305236053, -112.71983915902433 27.82533009633307, -112.70367340278355 27.755129291201627, -112.6605647194748 27.70893497901669, -112.64249710955863 27.709480581129107, -112.59526774328654 27.65055555298769, -112.53060471832342 27.638006704402017, -112.4241009125018 27.591994259587885, -112.3600718387638 27.552892774864414, -112.32393661893147 27.493604011981382, -112.30365017972734 27.38702973268857, -112.24120598405217 27.325194826614243, -112.1999991544188 27.252447878291505, -112.21616491065959 27.210254648264318, -112.15847534917287 27.162059795000502, -112.08905769002128 27.130778607221725, -112.00917983565506 27.116229217557176, -111.9537091034563 27.09640567413923, -112.00632705514198 27.032570226986028, -112.01044773810533 26.961278217629744, -111.97589739633581 26.9361805204584, -111.9502223717181 26.89125927986911, -111.90235905422088 26.85324899937048, -111.82248119985466 26.896169698880893, -111.74830890651461 26.845792437167397, -111.72326783312202 26.809418963006028, -111.6674801253107 26.772863621473853, -111.64909553978197 26.746492852706858, -111.56224422193934 26.697206795218204, -111.56985163664088 26.57171830936148, -111.56161027071421 26.55571398073048)))",2023,Total,867766,849224,867766,18542,18542,2.18
8,,32,Zacatecas,"POLYGON ((-101.60033467026697 24.754135805517862, -101.59779886536646 24.753953938147056, -101.46181632757636 24.736676537920406, -101.44882032746122 24.746133641202363, -101.40222491241425 24.788145003858745, -101.34231652163959 24.813242701030088, -101.20157934966102 24.765411582507888, -101.164493202991 24.681388857195124, -101.12772403193352 24.623191298536934, -101.08081164127401 24.59118264127493, -100.9590930060493 24.542442185898693, -100.90235437140028 24.583907946442658, -100.84783456603921 24.555536636596788, -100.799971248542 24.556264106080015, -100.74228168705528 24.460420001664808, -100.85068734655229 24.343297414865198, -100.94546305470902 24.281280641420064, -101.00663934793394 24.33565898529131, -101.01012607967216 24.385126910150774, -100.9876208111801 24.43259429393136, -101.01297886018523 24.390582931274977, -101.06527983625836 24.206896886760063, -101.17368549575536 24.164158054620454, -101.21679417906411 24.159611370350284, -101.20950373997513 24.086864422027546, -101.19302100812179 23.918637104031212, -101.34073164357677 23.79714970033224, -101.46657096176482 23.693667166343147, -101.77498823278992 23.447600613641484, -102.01240296660063 23.37267125686906, -102.12239350416046 23.35375705030515, -102.16898891920742 23.361031745137424, -102.16898891920742 23.398860158265247, -102.19181116331205 23.401406301456543, -102.19371301698743 23.447600613641484, -102.23808960274644 23.446691276787448, -102.2536214077621 23.365032827295174, -102.29641311545828 23.32029345407669, -102.25488931021235 23.280828234611604, -102.28595292024366 23.273189805037717, -102.28943965198187 23.231724044493756, -102.23967448080927 23.209354357884514, -102.24094238325952 23.1691616689362, -102.21431643180412 23.13133325580838, -102.25996092001338 23.04585559152916, -102.23396891978311 23.024940843886373, -102.19719974872564 22.88272055991542, -102.19212813892462 22.86489755757635, -102.12492930906097 22.782693505971654, -101.94837389286263 22.651930866361532, -101.94615506357468 22.650475927395078, -101.85328120909332 22.65593194851928, -101.87293369707231 22.562815854666177, -101.82031574538664 22.55117634293454, -101.83711545285254 22.499526009625395, -101.79939535495738 22.470609097667108, -101.79812745250713 22.470063495554687, -101.77150150105172 22.488068365264564, -101.73536628121938 22.48024806831987, -101.74614345204657 22.508619378165736, -101.69606130526141 22.520440757268183, -101.6561223780783 22.513893531919138, -101.57402569442414 22.612647514267252, -101.56768618217285 22.656841285373318, -101.49731759618356 22.7015806585918, -101.49129505954484 22.74195521491092, -101.41110022956606 22.747593103405933, -101.34960696072858 22.711765231356985, -101.36608969258192 22.69175982056823, -101.38003661953475 22.67575549193723, -101.33724491183857 22.658659959081383, -101.29350227730468 22.58445807179219, -101.28589486260314 22.50789190868251, -101.31410569212137 22.453513564811264, -101.37464803412115 22.456241575373365, -101.3822554488227 22.35730572565444, -101.43328852244557 22.36312548152026, -101.41997554671786 22.315112495627254, -101.39176471719964 22.29983563647948, -101.41617183936708 22.267281377105054, -101.36989339993269 22.253277589552926, -101.324565887336 22.20962942055928, -101.3511918387914 22.176711426443244, -101.3413655948019 22.151977464013513, -101.32963749713701 22.13542753327009, -101.35087486317883 22.087050812635468, -101.35404461930447 22.044675715237474, -101.32773564346164 21.99702646408608, -101.37401408289603 21.989388034512192, -101.43043574193248 21.932281680078844, -101.41046627834093 21.908457054503145, -101.48305369361816 21.867536896071606, -101.49636666934586 21.809884939525837, -101.51063057191126 21.798791029906617, -101.53725652336666 21.810612409009064, -101.56261457237181 21.855351782227547, -101.57022198707337 21.91700482093107, -101.65105076827727 21.90772958501992, -101.6596091098165 21.94155691598999, -101.71095915905192 21.97392930799361, -101.75089808623504 22.014667599054345, -101.777841013303 22.007211036851263, -101.8019311598579 22.027762049752436, -101.86183955063257 22.028853253977278, -101.86437535553307 22.041583969933757, -101.96802638084162 22.11123917295278, -102.0260329179409 22.129789644775077, -102.00099184454831 22.167981792644515, -101.99972394209806 22.219450258582853, -102.02254618620269 22.24145621045048, -102.0374440399932 22.298744432254637, -102.07548111350093 22.306019127086913, -102.12429535783585 22.286923053152194, -102.15345711419177 22.290378533197522, -102.162015455731 22.348394224484906, -102.18895838279897 22.362398012037033, -102.25330443214953 22.37458312588109, -102.29007360320699 22.419868101211996, -102.29831496913367 22.459515188047888, -102.31194492047393 22.456969044856592, -102.32145418885086 22.38858691343322, -102.35917428674603 22.384767698646275, -102.37850979911245 22.36094307307058, -102.46853087308072 22.35166783715943, -102.47106667798124 22.336209110640848, -102.46219136082944 22.322932792571947, -102.52590345895487 22.290924135309943, -102.61212082557238 22.291469737422364, -102.66917643583396 22.29165160479317, -102.67012736267165 22.24563915997904, -102.6412825819283 22.22836175975239, -102.69390053361398 22.104691947603733, -102.74556755846197 22.080503587286422, -102.8057929248492 21.996298994602853, -102.84351302274435 21.926280056842216, -102.86855409613693 21.860625935980945, -102.8476337057077 21.83316396298911, -102.8536562423464 21.798791029906617, -102.74556755846197 21.720042458347255, -102.74810336336249 21.715859508818696, -102.76205029031532 21.692034883243, -102.80515897362406 21.670938268229406, -102.80325711994868 21.66730092081327, -102.76522004644096 21.5963726461986, -102.71735672894374 21.57145681639806, -102.69675331412705 21.543085506552192, -102.63177331355136 21.534355872753466, -102.62479985007495 21.501437878637425, -102.654595557656 21.447241402136985, -102.6590332162319 21.409049254267547, -102.64286745999112 21.367219758981975, -102.6821724359491 21.33921218387772, -102.72940180222119 21.387407037141532, -102.72781692415836 21.35703518621679, -102.77060863185456 21.315751293043636, -102.7915290222838 21.327936406887694, -102.81593614445126 21.294290943288427, -102.83717351049306 21.303202444457963, -102.86379946194847 21.252825182744466, -102.89898375494312 21.23754832359669, -102.91071185260799 21.204994064222266, -102.94811497489059 21.21463303487503, -102.99692921922549 21.259736142835127, -103.02672492680655 21.242095007866862, -103.04986414652375 21.263191622880456, -103.08473146390583 21.194082021973855, -103.07173546379069 21.15334373091312, -103.09867839085865 21.13097404430388, -103.05842248806297 21.098419784929455, -103.05778853683785 21.09914725441268, -103.07490521991633 21.074231424612144, -103.12625526915176 21.054771615935813, -103.20993683086874 21.09405496803009, -103.25843409959108 21.08314292578168, -103.27745263634495 21.05131613589048, -103.2974220999365 21.06404685184696, -103.3471872711091 21.044223308429014, -103.36937556398861 21.052043605373708, -103.41850678393608 21.115151583043684, -103.41660493026069 21.137703137023735, -103.46922288194638 21.143341025518744, -103.50440717494102 21.127700431629357, -103.51138063841744 21.146250903451655, -103.55353839488849 21.116788389380947, -103.59569615135955 21.13279271801195, -103.61471468811341 21.158254149924907, -103.6245409321029 21.192990817749013, -103.6353181029301 21.197173767277572, -103.64102366395625 21.28447010526486, -103.66574776173627 21.290471728501483, -103.71646385974657 21.26810204189224, -103.72121849393503 21.307749128728133, -103.66352893244832 21.338120979652878, -103.51042971157975 21.354852777767107, -103.51486737015564 21.396318538311068, -103.53895751671054 21.44469525894569, -103.57160600480466 21.439784839933903, -103.58682083420776 21.392317456153318, -103.62422395649034 21.418506357549504, -103.66099312754781 21.441603513641972, -103.65877429825986 21.463427598138793, -103.70156600595604 21.466337476071704, -103.67272122521268 21.505438960795175, -103.69459254247963 21.52889985162926, -103.68666815216552 21.556361824621092, -103.64736317620753 21.57491229644339, -103.59316034645903 21.559089835183194, -103.59157546839621 21.588916083995517, -103.55512327295132 21.576549102780653, -103.5491007363126 21.649659785845003, -103.52691244343309 21.675484952499577, -103.50852785790435 21.739684134394395, -103.52913127272103 21.773147730622853, -103.57255693164235 21.803519581547597, -103.52627849220796 21.80497452051405, -103.5028222968782 21.83316396298911, -103.47049078439663 21.813340419571166, -103.4698568331715 21.839347453596545, -103.4191407351612 21.89609007328828, -103.38934502758016 21.898636216479577, -103.34528541743371 21.914094942998158, -103.33862892956986 21.94228438547322, -103.27903751440776 21.98884243239977, -103.26604151429262 21.972292501656348, -103.1925031721777 21.969746358465052, -103.20201244055463 21.998299535681728, -103.17253370858614 21.99648086197366, -103.11135741536123 22.01430386431273, -103.10628580556019 22.047039991057964, -103.10787068362302 22.063408054430578, -103.15414912305741 22.072319555600114, -103.12688922037688 22.103964478120506, -103.07712404920427 22.127607236325396, -103.10248209820942 22.153432402979966, -103.10596882994763 22.1914426834786, -103.05271692703683 22.2207233301785, -103.05747156122528 22.237636995663536, -103.07902590287966 22.258006141193903, -103.09899536647121 22.292379074276397, -103.19091829411488 22.29856256488383, -103.22261585537132 22.28346757310686, -103.2102538064813 22.32802507895454, -103.16873000123537 22.35457771509234, -103.16873000123537 22.384767698646275, -103.19884268442898 22.38040288174691, -103.21944609924567 22.41059286530085, -103.23244209936081 22.39313359770339, -103.28569400227161 22.413502743233757, -103.30566346586318 22.390405587141288, -103.36462092980014 22.3694908394985, -103.34306658814576 22.335117906416006, -103.35447771019808 22.279466490949112, -103.32816873435524 22.30729219868256, -103.29773907554906 22.298380697513025, -103.29932395361189 22.24891277265356, -103.33799497834474 22.245093557866618, -103.40899751555915 22.215449176425103, -103.42643117425018 22.139064880686227, -103.44988736957995 22.114330918256496, -103.51581829699333 22.10996610135713, -103.5383235654854 22.121423745717962, -103.58048132195647 22.125788562617327, -103.60457146851135 22.097780987513072, -103.684132347265 22.109238631873904, -103.69078883512886 22.128334705808623, -103.66131010316037 22.166708721048867, -103.63088044435419 22.238728199888378, -103.59949985871032 22.277647817241043, -103.63817088344318 22.295288952209308, -103.6353181029301 22.343301938102314, -103.60710727341187 22.338209651719723, -103.5944282489093 22.407137385255517, -103.57255693164235 22.43750923618026, -103.58523595614493 22.52535117627997, -103.61059400515008 22.559542241991654, -103.6619440543855 22.547357128147596, -103.72724103057375 22.574091631656202, -103.76908181143224 22.55572302720471, -103.78683244573585 22.477701925128574, -103.81028864106561 22.427324663415078, -103.81155654351588 22.376583666959966, -103.84547293406025 22.342756335989893, -103.82835625098178 22.287832390006226, -103.86322356836386 22.166708721048867, -103.90189459309671 22.23709139355112, -103.9259847396516 22.331662426370677, -103.86639332448951 22.41495768220021, -103.88572883685593 22.473518975600015, -103.86258961713874 22.501708418075076, -103.87558561725388 22.521531961493025, -103.85561615366231 22.574273499027008, -103.77383644562072 22.611192575300798, -103.75481790886685 22.71958552830168, -103.780175957872 22.729951968437668, -103.8540312755995 22.729770101066862, -103.90918503218569 22.75013924659723, -104.02614903322194 22.743228286506568, -104.07306142388146 22.693032892163878, -104.01537186239474 22.66866266447576, -104.02519810638424 22.652112733732338, -104.01537186239474 22.595915716153023, -103.972263179086 22.544992852327105, -104.00554561840525 22.53662695326999, -103.93327517874059 22.489159569489406, -103.96053508142111 22.433144419280897, -104.004277715955 22.40986539581762, -104.02361322832142 22.364398553115908, -104.04897127732657 22.37640179958916, -104.09461576553583 22.35494144983395, -104.05182405783965 22.46642614813855, -104.07940093613274 22.533171473224662, -104.12092474137867 22.515530338256397, -104.1136343022897 22.496434264321678, -104.16530132713768 22.513529797177522, -104.19478005910617 22.50389082652476, -104.1998516689072 22.456241575373365, -104.1722747906141 22.440237246742363, -104.16466737591256 22.39149679136613, -104.208726986059 22.422414244403292, -104.25437147426827 22.392769862961778, -104.25627332794366 22.349121693968133, -104.29240854777599 22.344393142327156, -104.29304249900112 22.365126022599135, -104.3500981092627 22.38640450498354, -104.34914718242501 22.409683528446813, -104.29621225512676 22.47279150611679, -104.32125332851935 22.535535749045152, -104.26039401090699 22.595915716153023, -104.28923879165035 22.64920285579943, -104.26324679142007 22.717584987222804, -104.22140601056158 22.77941989329713, -104.18717264440463 22.760505686733218, -104.08035186297045 22.769962790015175, -104.11141547300174 22.810882948446714, -104.10729479003841 22.882174957803, -104.15167137579742 22.92236764675131, -104.16752015642564 22.955649375608964, -104.16308249784974 22.974745449543683, -104.17385966867693 22.98238387911757, -104.1722747906141 23.128423377875468, -104.12916610730535 23.182256119634296, -104.11426825351482 23.317201708772973, -104.10983059493893 23.355030121900796, -104.06513703356735 23.463423074901677, -103.99635332564088 23.51470967346921, -103.89048347104439 23.57981819221806, -103.87938932460465 23.611644982109258, -103.84927664141102 23.640016291955128, -103.81155654351588 23.613645523188133, -103.78524756767303 23.676389766116493, -103.85117849508642 23.67966337879102, -103.84103527548436 23.701305595917034, -103.86258961713874 23.752592194484563, -103.81599420209177 23.80751614046823, -103.84769176334821 23.860985147485444, -103.81853000699229 23.964649548845344, -103.83786551935872 23.964103946732926, -103.8727328367408 24.00702464624334, -103.81028864106561 24.039942640359378, -103.74562561610249 24.08904683047723, -103.66067615193525 24.149244930214294, -103.63626902976779 24.11014344549082, -103.55924395591465 24.198349120332143, -103.56304766326542 24.257092281102754, -103.56875322429158 24.286372927802656, -103.50662600422896 24.28800973413992, -103.46256639408253 24.320382126143535, -103.43340463772661 24.358392406642167, -103.41945771077377 24.43023001811087, -103.38649224706708 24.422955323278597, -103.28284122175855 24.428775079144415, -103.25399644101519 24.447325550966713, -103.22324980659644 24.417135567412778, -103.20264639177977 24.421136649570528, -103.18774853798924 24.423319058020212, -103.1658772207223 24.435140437122655, -103.09867839085865 24.401676840894197, -103.04352463427246 24.466421624901432, -102.98361624349779 24.43313989604378, -102.96745048725701 24.457691991102706, -102.90120258423106 24.42859321177361, -102.89137634024156 24.460601869035614, -102.83210190069204 24.38476317540916, -102.78899321738328 24.40604165779356, -102.75190707071326 24.375851674239623, -102.66251994797011 24.381489562734636, -102.61180384995981 24.40040376929855, -102.60673224015878 24.410952076805344, -102.53414482488155 24.40767846413082, -102.48057594635817 24.427683874919573, -102.48025897074561 24.490428117847937, -102.494522873311 24.61246112365933, -102.51227350761461 24.709578299670184, -102.56647633736311 24.901993977983828, -102.67298014318473 24.942732269044562, -102.67298014318473 24.97856014109351, -102.64318443560369 24.978378273722704, -102.62892053303828 25.008386389905834, -102.66981038705909 25.066402081193218, -102.44665955581378 24.999474888736298, -102.45394999490277 25.048215344112535, -102.46377623889227 25.11587000605268, -102.29546218862059 25.12514524196383, -102.23777262713388 25.118416149243977, -102.08182062575221 25.070766898092582, -101.84916052612999 25.017661625816984, -101.83204384305151 24.972012915744465, -101.77340335472711 24.875623209216837, -101.68560111004679 24.839977204538695, -101.65675632930343 24.860710084810677, -101.60128559710466 24.83561238763933, -101.60920998741878 24.7895999428252, -101.64122452428778 24.800693852444418, -101.62252296314648 24.759046224529648, -101.60033467026697 24.754135805517862))",2023,Total,1683013,1667567,1683013,15446,15446,0.93
9,,10,Durango,"POLYGON ((-105.9318064159588 26.765588926641577, -105.89408631806364 26.741036831582655, -105.86555851293285 26.747402189560894, -105.77585441457714 26.660833321056835, -105.79423900010588 26.698843601555467, -105.74637568260866 26.713938593332436, -105.67505616978168 26.617548886804805, -105.60120085205419 26.614820876242703, -105.61958543758291 26.68356674240769, -105.54921685159363 26.546620612190136, -105.49628192429539 26.542801397403192, -105.49596494868283 26.526978936142996, -105.4712408509028 26.508610331691507, -105.45602602149971 26.52952507933429, -105.38946114286121 26.524069058210088, -105.34825431322784 26.51242954647845, -105.35712963037963 26.485695042969844, -105.3175076788091 26.462416019506566, -105.28802894684061 26.488786788273558, -105.26488972712342 26.461870417394145, -105.10196426226534 26.521341047647986, -105.0569537252812 26.419313452625346, -104.99767928573166 26.455505059415906, -104.96661567570035 26.448048497212824, -104.89878289461159 26.51006527065796, -104.85916094304105 26.504609249533754, -104.809712747481 26.508428464320698, -104.74790250303096 26.492424135689696, -104.62016133116752 26.36875432354104, -104.59385235532469 26.38021196790187, -104.57451684295826 26.340383013695174, -104.50097850084333 26.414584900984366, -104.4959068910423 26.46678083640593, -104.43473059781738 26.604454436106714, -104.33076259689628 26.656468504157473, -104.28638601113727 26.725396237693268, -104.31744962116858 26.760496640258985, -104.31523079188062 26.798688788128423, -104.27307303540957 26.84215508975126, -104.22806249842543 26.77704657100241, -104.18400288827898 26.77359109095708, -104.04580152120093 26.74303737266153, -104.03312249669835 26.774318560440307, -103.99508542319063 26.77759217311483, -103.99413449635294 26.753585680168328, -103.93295820312802 26.75394941490994, -103.86132171468847 26.75394941490994, -103.6993471766681 26.72521437032246, -103.6584573226473 26.71939461445664, -103.63690298099291 26.692478243577227, -103.41597097903556 26.616821417321578, -103.37413019817707 26.60227202765703, -103.31675761230292 26.361843363450383, -103.26128688010417 26.28454973085747, -103.35067400284731 26.142329446886517, -103.34687029549654 25.87698495287933, -103.32278014894165 25.82515275219938, -103.33926288079499 25.72548943299723, -103.35542863703577 25.69129836728554, -103.383639466554 25.639829901347202, -103.42484629618737 25.623643705345394, -103.45464200376841 25.557989584484123, -103.49331302850126 25.538347908436982, -103.47556239419767 25.517978762906615, -103.36937556398861 25.416496769996396, -103.34148171008295 25.410131412018156, -103.33704405150704 25.371393662036297, -103.40709566188376 25.398673767657325, -103.46288336969509 25.37521287682324, -103.49394697972639 25.311559297040844, -103.50567507739127 25.276640761845933, -103.43403858895174 25.199892731365445, -103.3988542959571 25.17624997316055, -103.35828141754885 25.10877717859121, -103.26223780694185 25.058581784248524, -103.2742828802193 25.020753371120698, -103.24638902631364 24.99529193920774, -103.25906805081621 24.964374486170577, -103.09709351279584 24.82651901909899, -102.98900482891139 24.796147168174244, -102.923073901498 24.78032470691405, -102.88376892554002 24.75104406021415, -102.85619204724692 24.740859487448965, -102.85302229112128 24.771776940486127, -102.66981038705909 25.066402081193218, -102.62892053303828 25.008386389905834, -102.64318443560369 24.978378273722704, -102.67298014318473 24.97856014109351, -102.67298014318473 24.942732269044562, -102.56647633736311 24.901993977983828, -102.51227350761461 24.709578299670184, -102.494522873311 24.61246112365933, -102.48025897074561 24.490428117847937, -102.48057594635817 24.427683874919573, -102.53414482488155 24.40767846413082, -102.60673224015878 24.410952076805344, -102.61180384995981 24.40040376929855, -102.66251994797011 24.381489562734636, -102.75190707071326 24.375851674239623, -102.78899321738328 24.40604165779356, -102.83210190069204 24.38476317540916, -102.89137634024156 24.460601869035614, -102.90120258423106 24.42859321177361, -102.96745048725701 24.457691991102706, -102.98361624349779 24.43313989604378, -103.04352463427246 24.466421624901432, -103.09867839085865 24.401676840894197, -103.1658772207223 24.435140437122655, -103.18774853798924 24.423319058020212, -103.20264639177977 24.421136649570528, -103.22324980659644 24.417135567412778, -103.25399644101519 24.447325550966713, -103.28284122175855 24.428775079144415, -103.38649224706708 24.422955323278597, -103.41945771077377 24.43023001811087, -103.43340463772661 24.358392406642167, -103.46256639408253 24.320382126143535, -103.50662600422896 24.28800973413992, -103.56875322429158 24.286372927802656, -103.56304766326542 24.257092281102754, -103.55924395591465 24.198349120332143, -103.63626902976779 24.11014344549082, -103.66067615193525 24.149244930214294, -103.74562561610249 24.08904683047723, -103.81028864106561 24.039942640359378, -103.8727328367408 24.00702464624334, -103.83786551935872 23.964103946732926, -103.81853000699229 23.964649548845344, -103.84769176334821 23.860985147485444, -103.81599420209177 23.80751614046823, -103.86258961713874 23.752592194484563, -103.84103527548436 23.701305595917034, -103.85117849508642 23.67966337879102, -103.78524756767303 23.676389766116493, -103.81155654351588 23.613645523188133, -103.84927664141102 23.640016291955128, -103.87938932460465 23.611644982109258, -103.89048347104439 23.57981819221806, -103.99635332564088 23.51470967346921, -104.06513703356735 23.463423074901677, -104.10983059493893 23.355030121900796, -104.11426825351482 23.317201708772973, -104.12916610730535 23.182256119634296, -104.1722747906141 23.128423377875468, -104.17385966867693 22.98238387911757, -104.16308249784974 22.974745449543683, -104.16752015642564 22.955649375608964, -104.15167137579742 22.92236764675131, -104.10729479003841 22.882174957803, -104.11141547300174 22.810882948446714, -104.08035186297045 22.769962790015175, -104.18717264440463 22.760505686733218, -104.22140601056158 22.77941989329713, -104.26324679142007 22.717584987222804, -104.28923879165035 22.64920285579943, -104.26039401090699 22.595915716153023, -104.32125332851935 22.535535749045152, -104.29621225512676 22.47279150611679, -104.34914718242501 22.409683528446813, -104.37196942652965 22.421686774920065, -104.49400503736692 22.376219932218355, -104.50668406186949 22.345120611810383, -104.55169459885363 22.388950648174834, -104.59321840409956 22.411865936896497, -104.60304464808905 22.460424524901924, -104.65534562416217 22.462061331239184, -104.656930502225 22.539354963832096, -104.6702434779527 22.565180130486667, -104.71525401493683 22.55590489457552, -104.7618494299838 22.570090549498453, -104.77928308867483 22.643019365191996, -104.85884396742848 22.648111651574588, -104.86264767477925 22.607009625772243, -104.9609101146742 22.505345765491214, -104.98785304174217 22.498798540142168, -105.00750552972116 22.58573114338784, -105.07280250590942 22.656477550631703, -105.05758767650633 22.687940605781286, -104.89276035797286 22.73740853064075, -104.91589957769007 22.74832057288916, -104.90607333370058 22.799970906198304, -104.93269928515598 22.82725101181933, -104.95900826099881 22.81361095900882, -104.9875360661296 22.845074014158403, -104.98912094419244 22.89072272423092, -105.00972435900911 22.92127644252647, -105.00338484675783 22.976927857993367, -105.07628923764763 22.959468590395907, -105.16345753110282 22.9538307019009, -105.2978551908301 22.95419443664251, -105.32353021544782 22.941281853315225, -105.35427684986657 23.020212292245397, -105.3583975328299 23.073863166633416, -105.39231392337427 23.0840477393986, -105.41608709431661 23.116965733514636, -105.50230446093411 23.127877775763046, -105.55492241261979 23.09896086380476, -105.59708016909084 23.109145436569943, -105.64494348658806 23.14279090016921, -105.63004563279755 23.202261530423048, -105.64304163291268 23.2753722134874, -105.68519938938374 23.28573865362339, -105.71816485309043 23.368488307340506, -105.730843877593 23.374853665318746, -105.7007311943994 23.420502375391262, -105.73876826790712 23.444690735708573, -105.72355343850403 23.475244454004123, -105.76032260956148 23.502706426995957, -105.76856397548816 23.555084229788328, -105.794872951331 23.580000059588865, -105.81167265879691 23.611099379996837, -105.88426007407415 23.59036649972486, -105.89281841561339 23.552538086597032, -105.90930114746673 23.59018463235405, -105.92705178177033 23.68402819569038, -105.90613139134109 23.739315876415663, -105.92705178177033 23.7615036956541, -105.95177587955035 23.81970125431229, -105.96128514792728 23.840797869325883, -105.95399470883831 23.90845253126603, -105.86746036660824 23.875170802408377, -105.85795109823131 23.89990476483811, -105.8997918790898 23.943916668573365, -105.94543636729907 23.947917750731115, -105.90866719624161 23.98338188803845, -105.9150067084929 23.99956808404026, -105.99995617266013 24.045944263596006, -105.98981295305808 24.101959413804515, -106.00312592878578 24.146880654393804, -106.04401578280658 24.22090067431219, -106.07000778303686 24.220173204828964, -106.07476241722533 24.269277394946812, -106.15242144230359 24.338750730595027, -106.2687514921147 24.374760470014785, -106.32802593166424 24.36112041720427, -106.36321022465889 24.304014062770918, -106.4697140304805 24.277825161374736, -106.50838505521335 24.290919612072827, -106.51726037236516 24.286918529915077, -106.58604408029161 24.37894341954334, -106.60157588530727 24.414589424221482, -106.56924437282571 24.436959110830724, -106.56670856792519 24.47460565658774, -106.63010369043806 24.50643244647894, -106.683989544574 24.598457336107202, -106.70617783745351 24.665202661193316, -106.86086193638491 24.81833498741268, -106.8859030097775 24.826337151728183, -106.93059657114907 24.820881130603976, -106.94644535177729 24.858527676360993, -106.92710983941086 24.8667117080473, -107.01839881582939 24.93363890050422, -107.068163987002 25.030392341773464, -107.12997423145204 25.053125763124317, -107.12521959726358 25.186434545925735, -107.14867579259334 25.224626693795173, -107.12109891430023 25.242449696134244, -107.14835881698077 25.258999626877667, -107.20826720775544 25.3315647078296, -107.17149803669797 25.326290554076202, -107.21016906143082 25.417042372108817, -107.15564925606975 25.44668675355033, -107.14804184136821 25.50506617957933, -107.17815452456182 25.515250752344514, -107.17023013424772 25.559626390821386, -107.13155910951487 25.550351154910235, -106.97338827884525 25.62964532858202, -106.9943086692745 25.662199587956444, -106.8992159855052 25.643830983504955, -106.87385793650004 25.571629637294635, -106.74484886218636 25.585087822734344, -106.68208769089861 25.579086199497716, -106.6529259345427 25.55871705396735, -106.60442866582035 25.634555747593804, -106.53596193350646 25.676748977620992, -106.46400846945434 25.741675628999037, -106.555931397098 25.691480234656346, -106.56005208006134 25.91263095755747, -106.54737305555877 25.952459911764173, -106.45608407914024 25.97264718992373, -106.44467295708792 26.00501958192735, -106.4716158841559 26.06030726265263, -106.45893685965332 26.112139463332582, -106.415511200732 26.1392377015828, -106.43294485942305 26.20398248559004, -106.42406954227124 26.214530793096834, -106.31249412664859 26.34856704538148, -106.28713607764344 26.335108859941776, -106.27540797997855 26.367481251945392, -106.30235090704653 26.36366203715845, -106.29759627285806 26.396398163903683, -106.26463080915137 26.405855267185636, -106.2421255406593 26.46678083640593, -106.27001939456497 26.526978936142996, -106.24149158943418 26.544801938482067, -106.2199372477798 26.656286636786664, -106.19014154019875 26.694478784656102, -106.1318180274869 26.713756725961627, -106.17682856447105 26.727760513513754, -106.1780964669213 26.772318019361432, -106.12547851523561 26.7794108468229, -106.10107139306817 26.759223568663337, -106.0785661245761 26.79832505338681, -106.04718553893223 26.844701232942555, -105.93909685504778 26.76304278345028, -105.9318064159588 26.765588926641577))",2023,Total,1899457,1884286,1899457,15171,15171,0.81
10,,8,Chihuahua,"POLYGON ((-106.86783539986132 31.78385528931488, -106.52867149441747 31.78385528931488, -106.48778164039668 31.747481815153506, -106.4510124693392 31.764213613267735, -106.38159481018761 31.73220495600573, -106.30330183388422 31.62217519666759, -106.28047958977959 31.56179522955972, -106.24973295536084 31.54488156407468, -106.21962027216723 31.4815917190339, -106.18316807672232 31.457948960829007, -106.07539636845046 31.397750861091943, -106.02055958747682 31.393749778934193, -105.95526261128856 31.36501473434671, -105.93085548912111 31.31245506418353, -105.87063012273389 31.28953977546187, -105.80881987828384 31.21879336821801, -105.77426953651432 31.167688637021286, -105.74225499964533 31.164596891717565, -105.7096065115512 31.1362255818717, -105.64843021832627 31.1151289668581, -105.60437060817983 31.083120309596097, -105.55619031507005 30.988731144147344, -105.41608709431661 30.900161734564414, -105.39484972827479 30.85869597402045, -105.31909255687192 30.812319794464706, -105.29024777612857 30.825050510421185, -105.25855021487213 30.794860526867247, -105.21766036085133 30.80577256911566, -105.1609217262023 30.751576092615217, -105.11844699411868 30.74902994942392, -105.05473489599325 30.682102756967005, -105.00750552972116 30.68592197175395, -104.97105333427626 30.609355808644267, -104.92699372412982 30.60444538963248, -104.89878289461159 30.56989058917918, -104.86645138213002 30.494051895552726, -104.86867021141798 30.472591545797517, -104.84774982098872 30.414575854510133, -104.85916094304105 30.390387494192822, -104.81161460115639 30.366744735987933, -104.82239177198358 30.350922274727736, -104.7599475763084 30.271628101055953, -104.73046884433992 30.258897385099473, -104.68672620980604 30.17905760931527, -104.69655245379553 30.1346819708384, -104.68862806348143 30.0735745342473, -104.70669567339759 30.050659245525637, -104.67341323407834 29.956088212706078, -104.6826055268427 29.928444372343435, -104.63410825812036 29.871156150539278, -104.62047830678009 29.830963461590965, -104.59226747726187 29.810412448689792, -104.54979274517824 29.740939113041577, -104.54472113537722 29.681650350158545, -104.46769606152408 29.610903942914682, -104.39891235359761 29.57289366241605, -104.38591635348247 29.544522352570183, -104.33805303598525 29.520879594365294, -104.26356376703264 29.51415050164544, -104.20904396167157 29.481778109641823, -104.21791927882337 29.45613481035806, -104.1624485466246 29.391571893721625, -104.10792874126354 29.37356702401175, -104.03787713088681 29.31991614962373, -103.97036132541061 29.29681899353126, -103.78334571399765 29.265355938381674, -103.78176083593482 29.228073127366272, -103.7427728355894 29.222071504129644, -103.71931664025965 29.18187881518133, -103.55417234611362 29.158417924347248, -103.43403858895174 29.044387082851358, -103.35796444193629 29.0189256509384, -103.34591936865884 29.046751358671848, -103.30693136831343 29.004012526532236, -103.35764746632373 28.92017166859028, -103.40360893014555 28.869248804764364, -103.40994844239684 28.84069562754769, -103.51455039454308 28.665011747348277, -103.55734210223926 28.61117900558945, -103.59664707819725 28.63955031543532, -103.63753693221804 28.554436385897716, -103.64260854201908 28.54479741524495, -103.64292551763164 28.512425023241335, -103.7294598598617 28.35456414538099, -103.76813088459456 28.30036766888055, -103.8673442513272 28.112134940095466, -103.9269356664893 27.971369595090966, -103.87812142215438 27.957547674909648, -103.89301927594491 27.914081373286812, -103.94215049589238 27.927539558726515, -103.95990113019599 27.835332801727446, -103.90126064187159 27.826603167928717, -103.9358109836411 27.797322521228814, -103.8816081538926 27.739124962570624, -103.89713995890824 27.656557176224318, -103.88351000756798 27.600723893386615, -103.86037078785078 27.571261379315906, -103.85466522682462 27.54961916218989, -103.87685351970413 27.311372906432922, -103.83215995833255 27.29827845573483, -103.81979790944254 27.24299077500955, -103.7988775190133 27.21352826093884, -103.79951147023843 27.1247769839851, -103.78334571399765 27.091131520385833, -103.75545186009198 27.081674417103876, -103.74499166487736 27.02274938896246, -103.780175957872 27.00892746878114, -103.7846136164479 26.980738026306078, -103.8521294219241 26.934725581491946, -103.85181244631154 26.896169698880893, -103.77985898225944 26.836153466514634, -103.75418395764173 26.82942437379478, -103.6993471766681 26.72521437032246, -103.86132171468847 26.75394941490994, -103.93295820312802 26.75394941490994, -103.99413449635294 26.753585680168328, -103.99508542319063 26.77759217311483, -104.03312249669835 26.774318560440307, -104.04580152120093 26.74303737266153, -104.18400288827898 26.77359109095708, -104.22806249842543 26.77704657100241, -104.27307303540957 26.84215508975126, -104.31523079188062 26.798688788128423, -104.31744962116858 26.760496640258985, -104.28638601113727 26.725396237693268, -104.33076259689628 26.656468504157473, -104.43473059781738 26.604454436106714, -104.4959068910423 26.46678083640593, -104.50097850084333 26.414584900984366, -104.57451684295826 26.340383013695174, -104.59385235532469 26.38021196790187, -104.62016133116752 26.36875432354104, -104.74790250303096 26.492424135689696, -104.809712747481 26.508428464320698, -104.85916094304105 26.504609249533754, -104.89878289461159 26.51006527065796, -104.96661567570035 26.448048497212824, -104.99767928573166 26.455505059415906, -105.0569537252812 26.419313452625346, -105.10196426226534 26.521341047647986, -105.26488972712342 26.461870417394145, -105.28802894684061 26.488786788273558, -105.3175076788091 26.462416019506566, -105.35712963037963 26.485695042969844, -105.34825431322784 26.51242954647845, -105.38946114286121 26.524069058210088, -105.45602602149971 26.52952507933429, -105.4712408509028 26.508610331691507, -105.49596494868283 26.526978936142996, -105.49628192429539 26.542801397403192, -105.54921685159363 26.546620612190136, -105.61958543758291 26.68356674240769, -105.60120085205419 26.614820876242703, -105.67505616978168 26.617548886804805, -105.74637568260866 26.713938593332436, -105.79423900010588 26.698843601555467, -105.77585441457714 26.660833321056835, -105.86555851293285 26.747402189560894, -105.89408631806364 26.741036831582655, -105.9318064159588 26.765588926641577, -105.93909685504778 26.76304278345028, -106.04718553893223 26.844701232942555, -106.0785661245761 26.79832505338681, -106.10107139306817 26.759223568663337, -106.12547851523561 26.7794108468229, -106.1780964669213 26.772318019361432, -106.17682856447105 26.727760513513754, -106.1318180274869 26.713756725961627, -106.19014154019875 26.694478784656102, -106.2199372477798 26.656286636786664, -106.24149158943418 26.544801938482067, -106.27001939456497 26.526978936142996, -106.2421255406593 26.46678083640593, -106.26463080915137 26.405855267185636, -106.29759627285806 26.396398163903683, -106.30235090704653 26.36366203715845, -106.27540797997855 26.367481251945392, -106.28713607764344 26.335108859941776, -106.31249412664859 26.34856704538148, -106.42406954227124 26.214530793096834, -106.43294485942305 26.20398248559004, -106.415511200732 26.1392377015828, -106.45893685965332 26.112139463332582, -106.4716158841559 26.06030726265263, -106.44467295708792 26.00501958192735, -106.45608407914024 25.97264718992373, -106.54737305555877 25.952459911764173, -106.56005208006134 25.91263095755747, -106.555931397098 25.691480234656346, -106.46400846945434 25.741675628999037, -106.53596193350646 25.676748977620992, -106.60442866582035 25.634555747593804, -106.6529259345427 25.55871705396735, -106.68208769089861 25.579086199497716, -106.74484886218636 25.585087822734344, -106.87385793650004 25.571629637294635, -106.8992159855052 25.643830983504955, -106.9943086692745 25.662199587956444, -106.96704876659396 25.668383078563878, -106.96546388853115 25.697845592634586, -106.99050496192373 25.71494112549043, -107.01047442551528 25.691480234656346, -107.06467725526379 25.71912407501899, -107.0583377430125 25.757316222888427, -107.19495423202774 25.852069123078792, -107.24693823248829 25.878985493958204, -107.24281754952494 25.892261812027105, -107.29606945243576 25.92481607140153, -107.27641696445677 26.001927836623633, -107.30684662326294 26.04866775092099, -107.30494476958756 26.076311591283634, -107.3464685748335 26.109593320141286, -107.41652018521022 26.14123824266168, -107.46216467341948 26.137419027874735, -107.52017121051875 26.10413729901708, -107.55567247912596 26.159606847113167, -107.73508067583738 26.16815461354109, -107.75505013942893 26.134509149941824, -107.78104213965922 26.136691558391504, -107.78896652997332 26.168518348282703, -107.85426350616157 26.196525923386957, -107.85616535983696 26.22580657008686, -107.90022496998341 26.286732139307155, -108.01275131244375 26.438955128672482, -107.99975531232862 26.44841223195444, -107.95759755585756 26.493697207285344, -107.96140126320833 26.526978936142996, -108.05173931278917 26.629915868019673, -108.08153502037021 26.641737247122116, -108.01497014173171 26.685749150857372, -108.00672877580503 26.705572694275318, -108.0060948245799 26.761042242371406, -108.0381093614489 26.769771876170136, -108.03715843461121 26.810146432489255, -108.09421404487279 26.87052639959713, -108.14429619165796 26.867616521664218, -108.14207736237 26.907081741129304, -108.17662770413952 26.88143844184554, -108.2301965826629 26.905808669533656, -108.23495121685136 26.958550207067642, -108.18201628955312 27.00310771291532, -108.19469531405569 27.032024624873607, -108.25048302186701 27.040936126043142, -108.28154663189832 27.012928550938888, -108.30373492477783 27.03657130914378, -108.33321365674631 27.004562651881773, -108.35001336421222 27.022567521591654, -108.42164985265177 27.021112582625197, -108.47046409698667 27.034570768064903, -108.50247863385567 26.987285251655123, -108.5725302442324 27.012746683568082, -108.5627040002429 27.046028412425734, -108.60232595181344 27.036935043885393, -108.59725434201242 27.07676399809209, -108.61151824457781 27.154057630685003, -108.64416673267193 27.17879159311473, -108.66477014748862 27.239353427593414, -108.5912318053737 27.317920131781968, -108.62958585449398 27.382846783160012, -108.63370653745731 27.42813175849092, -108.66191736697554 27.464505232652286, -108.65557785472426 27.543617538953264, -108.71326741621097 27.566169092933315, -108.73989336766637 27.599996423903388, -108.76588536789664 27.705661366342163, -108.83308419776029 27.744399116324022, -108.89584536904803 27.744762851065637, -108.91549785702702 27.7756803041028, -108.91042624722598 27.80896203296045, -108.8695363932052 27.839333883885196, -108.91961853999035 27.87097880640559, -108.92659200346677 27.94063400942461, -108.97857600392733 27.978826157294048, -109.03182790683813 28.018109509388324, -109.06796312667048 28.128321136097274, -109.06574429738252 28.182517612597714, -109.07525356575945 28.272541961147105, -109.02295258968634 28.277452380158888, -108.99886244313144 28.255264560920452, -108.98713434546656 28.277816114900503, -108.96145932084885 28.261993653640307, -108.75130448971869 28.27163262429307, -108.68759239159326 28.303459414184267, -108.64131395215885 28.291638035081824, -108.6365593179704 28.335286204075466, -108.60391082987627 28.347471317919524, -108.55097590257802 28.317826936478006, -108.51959531693414 28.334740601963045, -108.52149717060954 28.36493058551698, -108.4799733653636 28.369477269787154, -108.51547463397081 28.42603802210808, -108.50501443875619 28.493328949306616, -108.52339902428491 28.505877797892285, -108.53132341459903 28.556618794347397, -108.55160985380314 28.57771540936099, -108.58013765893394 28.632457487973852, -108.5839413662847 28.716298345915806, -108.5839413662847 28.739941104120696, -108.64321580583425 28.765038801292043, -108.68822634281838 28.87634163222583, -108.70661092834712 28.88398006179972, -108.69805258680788 28.936175997221284, -108.72975014806431 29.096583018272923, -108.698686538033 29.12768233868089, -108.72911619683919 29.171876109786957, -108.74559892869253 29.16223713913419, -108.73038409928944 29.269175153168618, -108.68220380617966 29.267356479460553, -108.66984175728965 29.307367301038056, -108.71770507478686 29.465773781010817, -108.64384975705937 29.48868906973248, -108.66255131820067 29.544522352570183, -108.63877814725835 29.558344272751505, -108.6552608791117 29.649277958154926, -108.61817473244166 29.66055373514495, -108.65938156207503 29.716205150611845, -108.59249970782395 29.717660089578303, -108.54083268297596 29.73602869402979, -108.54114965858852 29.79604492639605, -108.62990283010654 29.806229499161233, -108.634657464295 29.832054665815807, -108.60739756161448 29.846967790221967, -108.61563892754114 29.883523131754146, -108.62863492765628 29.953360202143973, -108.61563892754114 29.965727183358837, -108.61088429335268 30.042111479097713, -108.61754078121653 30.23598209637781, -108.62039356172961 30.298180737193753, -108.55065892696545 30.266717682044167, -108.54210058542621 30.28326761278759, -108.58013765893394 30.337464089288034, -108.62197843979243 30.34037396722094, -108.62007658611705 30.374746900303435, -108.6489213668604 30.416940130330623, -108.61373707386576 30.43567246952373, -108.60422780548883 30.46513498359444, -108.66508712310119 30.468226728898152, -108.6622343425881 30.521695735915365, -108.67808312321633 30.5571598732227, -108.72753131877636 30.58025702931517, -108.83086536847235 30.60171737907038, -108.87397405178109 30.623359596196394, -108.86731756391724 30.68937745179928, -108.91898458876523 30.739390978771162, -108.94814634512115 30.736844835579866, -108.93546732061857 30.77358204448285, -108.93134663765524 30.866334403594337, -108.93927102796934 30.907618296767495, -108.80265453895412 30.903980949351357, -108.80328849017924 31.00473547277835, -108.68410565985505 31.006008544373998, -108.68473961108018 31.033470517365828, -108.75257239216894 31.033834252107447, -108.73450478225277 31.053475928154583, -108.7662023435092 31.073663206314144, -108.77032302647255 31.102216383530816, -108.84576322226286 31.135316245017663, -108.80487336824206 31.192786334192625, -108.84829902716338 31.19496874264231, -108.86097805166595 31.218975235588815, -108.90028302762393 31.20242530484539, -108.87999658841981 31.23861691163595, -108.81723541713207 31.238798779006757, -108.75605912390715 31.332460474972287, -108.20864224100852 31.33318794445551, -108.20832526539596 31.783673421944073, -107.89293453089444 31.782945952460842, -107.25898330576574 31.783673421944073, -106.86783539986132 31.78385528931488))",2023,Total,3947936,3898274,3947936,49662,49662,1.27
11,,6,Colima,"MULTIPOLYGON (((-114.72661176216923 18.360224650061582, -114.68794073743638 18.362588925882072, -114.69459722530023 18.3420379129809, -114.75196981117438 18.332580809698943, -114.75704142097541 18.357314772128674, -114.72661176216923 18.360224650061582)), ((-110.98820138758529 18.85344895968975, -110.9197346552714 18.791068451503, -110.92227046017192 18.726141800124957, -110.95111524091527 18.71268361468525, -110.97266958256965 18.737781311856594, -111.0192649976166 18.74905708884662, -111.05064558326048 18.800707422155764, -111.01863104639148 18.81598428130354, -110.98820138758529 18.85344895968975)), ((-103.61820141985162 19.512354444122952, -103.61281283443803 19.488893553288868, -103.61566561495111 19.47488976573674, -103.56907019990415 19.406143899571752, -103.53800658987284 19.388139029861875, -103.5151843457682 19.351765555700506, -103.48633956502485 19.33776176814838, -103.50662600422896 19.29229492544667, -103.50947878474204 19.241553928991557, -103.51455039454308 19.21718370130344, -103.49775068707717 19.177354747096743, -103.52374268730745 19.113883034685152, -103.52279176046976 19.065870048792146, -103.48887536992537 19.027314166181093, -103.48887536992537 18.964751790623538, -103.55892698030209 18.90582676248212, -103.57255693164235 18.872181298882854, -103.58143224879416 18.876000513669798, -103.61978629791444 18.893096046525642, -103.64070668834368 18.867089012500262, -103.6245409321029 18.826168854068722, -103.63817088344318 18.783248154558308, -103.69871322544296 18.755604314195665, -103.73801820140095 18.68394857009777, -103.83501273884563 18.77142677545586, -103.94753908130598 18.842173182699725, -103.97131225224831 18.86436100193816, -104.11997381454098 18.944200777722365, -104.2220399617867 18.986212140378747, -104.33551723108474 19.0222218797985, -104.30508757227857 19.057140414993416, -104.30952523085446 19.083874918502023, -104.35295088977578 19.113701167314346, -104.3865503047076 19.1178841168429, -104.3954256218594 19.090240276480262, -104.41634601228866 19.106244605111264, -104.44202103690637 19.086239194322513, -104.48956737879101 19.124613209562757, -104.69021294154425 19.176445410242707, -104.6756320633663 19.185356911412242, -104.59004864797392 19.150074641475715, -104.60050884318854 19.178264083950776, -104.57673567224622 19.18081022714207, -104.55486435497927 19.236461642608965, -104.52316679372284 19.260286268184664, -104.49051830562871 19.23264242782202, -104.43948523200585 19.278109270523736, -104.40018025604788 19.289021312772146, -104.40144815849813 19.26683349353371, -104.34375859701142 19.289566914884567, -104.31491381626806 19.279382342119384, -104.24803196201698 19.312118468864615, -104.22330786423696 19.301570161357816, -104.12282659505406 19.32048436792173, -104.13328679026868 19.353584229408575, -104.0904950825725 19.39304944887366, -104.07115957020608 19.43524267890085, -104.0870083508343 19.441789904249895, -104.07211049704377 19.482164460569017, -104.07147654581864 19.48361939953547, -104.06196727744171 19.497623187087598, -103.96497273999702 19.454156885464762, -103.89967576380876 19.434515209417622, -103.88921556859414 19.46343212137591, -103.85466522682462 19.430877862001484, -103.83469576323307 19.43978936317102, -103.82138278750537 19.410872451212732, -103.716146884134 19.456339293914443, -103.6904718595163 19.492530900705006, -103.61820141985162 19.512354444122952)))",2023,Total,757405,752247,757405,5158,5158,0.69
12,,18,Nayarit,"MULTIPOLYGON (((-106.22817861370648 21.365764820015517, -106.25163480903623 21.32466279421317, -106.27889471171676 21.348123685047256, -106.22817861370648 21.365764820015517)), ((-106.43484671309842 21.49434505117596, -106.37715715161171 21.483069274185933, -106.36004046853324 21.460517720205885, -106.38634944437608 21.41977942914515, -106.49443812826053 21.46597374133009, -106.45893685965332 21.49525438802999, -106.43484671309842 21.49434505117596)), ((-106.65324291015526 21.693489822209454, -106.57494993385187 21.681850310477817, -106.5356449578939 21.65693448067728, -106.53849773840696 21.634201059326422, -106.5071171527631 21.602374269435224, -106.53406007983106 21.548723395047205, -106.54610515310851 21.563272784711753, -106.63073764166319 21.602010534693612, -106.65609569066834 21.656570745935664, -106.65324291015526 21.693489822209454)), ((-106.67352934935938 21.774602669589306, -106.65926544679398 21.737319858573905, -106.68747627631221 21.745867625001825, -106.67352934935938 21.774602669589306)), ((-105.00338484675783 22.976927857993367, -105.00972435900911 22.92127644252647, -104.98912094419244 22.89072272423092, -104.9875360661296 22.845074014158403, -104.95900826099881 22.81361095900882, -104.93269928515598 22.82725101181933, -104.90607333370058 22.799970906198304, -104.91589957769007 22.74832057288916, -104.89276035797286 22.73740853064075, -105.05758767650633 22.687940605781286, -105.07280250590942 22.656477550631703, -105.00750552972116 22.58573114338784, -104.98785304174217 22.498798540142168, -104.9609101146742 22.505345765491214, -104.86264767477925 22.607009625772243, -104.85884396742848 22.648111651574588, -104.77928308867483 22.643019365191996, -104.7618494299838 22.570090549498453, -104.71525401493683 22.55590489457552, -104.6702434779527 22.565180130486667, -104.656930502225 22.539354963832096, -104.65534562416217 22.462061331239184, -104.60304464808905 22.460424524901924, -104.59321840409956 22.411865936896497, -104.55169459885363 22.388950648174834, -104.50668406186949 22.345120611810383, -104.49400503736692 22.376219932218355, -104.37196942652965 22.421686774920065, -104.34914718242501 22.409683528446813, -104.3500981092627 22.38640450498354, -104.29304249900112 22.365126022599135, -104.29240854777599 22.344393142327156, -104.29557830390164 22.276920347757816, -104.32854376760832 22.24563915997904, -104.36499596305323 22.112512244548427, -104.36372806060297 21.97392930799361, -104.32759284077063 21.975384246960065, -104.2939934258388 22.0028462199519, -104.2451791815039 21.966836480532145, -104.19319518104335 21.985386952354443, -104.17385966867693 21.970837562689894, -104.1998516689072 21.894271399580212, -104.19668191278156 21.85062323058657, -104.1304340097556 21.790425130849503, -104.05245800906478 21.79460808037806, -103.98494220358857 21.77260212851043, -103.92249800791339 21.770783454802363, -103.93390912996571 21.7478681660807, -103.89048347104439 21.699309578075272, -103.9304223982275 21.641657621529504, -103.90791712973544 21.61874233280784, -103.9234489347511 21.589643553478744, -103.8914343978821 21.568365071094345, -103.85656708050001 21.552360742463343, -103.85149547069898 21.515441666189552, -103.80173029952638 21.489434632164173, -103.780175957872 21.49998293967097, -103.75006327467838 21.475430844612045, -103.72121849393503 21.425962919752585, -103.76432717724379 21.410322325863195, -103.74562561610249 21.363036809453416, -103.74942932345326 21.336666040686424, -103.80363215320176 21.300110699154246, -103.81853000699229 21.249005967957523, -103.8619556659136 21.248824100586717, -103.91774337372493 21.23081923087684, -103.97543293521164 21.251188376407207, -104.0175906916827 21.22609067923586, -104.03565830159887 21.195900695681924, -104.0717935214312 21.188444133478843, -104.100321326562 21.2006292473229, -104.16086366856179 21.1846249186919, -104.20397235187053 21.192263348265787, -104.21950415688619 21.17644088700559, -104.21062883973438 21.13042844219146, -104.22774552281287 21.05077053377806, -104.24105849854057 21.021671754448967, -104.23345108383901 20.968566482173365, -104.2052402543208 20.95965498100383, -104.25976005968187 20.893818992771752, -104.29018971848804 20.887999236905934, -104.29240854777599 20.848534017440848, -104.36246015815271 20.840713720496154, -104.35041508487527 20.811614941167058, -104.37577313388041 20.784152968175224, -104.32822679199576 20.79815675572735, -104.29748015757701 20.770694782735518, -104.28289927939906 20.783425498691997, -104.24771498640442 20.726501011629455, -104.24771498640442 20.68994567009728, -104.25722425478135 20.603558668964027, -104.28226532817393 20.62883823350618, -104.28733693797496 20.687399526905985, -104.35073206048783 20.725409807404613, -104.39669352430965 20.7808793555007, -104.4505793784456 20.80361277685156, -104.50351430574385 20.841804924720996, -104.54281928170182 20.91200572985244, -104.59068259919904 20.934557283832486, -104.61889342871727 20.92382710895488, -104.62903664831933 20.924190843696497, -104.68102064877988 20.943832519743637, -104.6791187951045 20.957108837812534, -104.72951791750222 20.983115871837914, -104.73173674679018 21.01221465116701, -104.79956952787894 21.01567013121234, -104.83570474771129 21.019307478628477, -104.96883450498831 20.909095851919528, -104.98912094419244 20.921280965763586, -105.0392030909776 20.91291506670647, -105.04776143251684 20.93437541646168, -105.08833431092508 20.923099639471655, -105.13905040893536 20.8818157462985, -105.17138192141692 20.821072044449014, -105.17328377509232 20.76778490480261, -105.19737392164721 20.777060140713758, -105.23509401954236 20.747415759272243, -105.24428631230673 20.703221988166177, -105.28137245897676 20.6719408003874, -105.31370397145832 20.729229022191557, -105.36442006946862 20.761783281565982, -105.3992873868507 20.735594380169797, -105.51973811962515 20.770876650106324, -105.49406309500743 20.789245254557816, -105.45127138731125 20.876359725174296, -105.42559636269354 20.886726165310286, -105.40214016736378 20.93146553852877, -105.35554475231682 20.96020058311625, -105.31814163003422 21.00639489530119, -105.31370397145832 21.034766205147058, -105.26805948324906 21.026400306089943, -105.24111655618108 21.051861738002902, -105.22843753167851 21.09641924385058, -105.23350914147954 21.17825956071366, -105.21670943401364 21.203720992626618, -105.2392147025057 21.361945605228573, -105.21829431207645 21.410322325863195, -105.18849860449541 21.446150197912143, -105.19769089725978 21.488161560568525, -105.23446006831723 21.526717443179578, -105.26552367834854 21.511804318773414, -105.41069850890301 21.599828126243928, -105.44556582628509 21.6309274466519, -105.53114924167747 21.807702531076153, -105.60532153501752 21.918277892526717, -105.63701909627396 21.974111175364417, -105.65318485251474 22.028307651864857, -105.64652836465089 22.169618598981778, -105.66269412089167 22.29219720690559, -105.68583334060887 22.37767487118481, -105.75873773149867 22.537718157494833, -105.70168212123708 22.467699219734197, -105.67727499906962 22.468062954475812, -105.67727499906962 22.5129841950651, -105.7007311943994 22.558451037766815, -105.68234660887066 22.571909223206518, -105.66047529160372 22.58627674550026, -105.60088387644163 22.558814772508427, -105.59866504715367 22.53662695326999, -105.54160943689209 22.53662695326999, -105.53400202219055 22.514984736143976, -105.50388933899693 22.526260513134, -105.4668031923269 22.505345765491214, -105.44176211893432 22.524441839425933, -105.43890933842124 22.587913551837524, -105.46426738742639 22.659205561193808, -105.49850075358334 22.65138526424911, -105.52290787575079 22.72431407994266, -105.52322485136335 22.77305453531889, -105.50230446093411 22.80997361159268, -105.4953309974577 22.81070108107591, -105.4712408509028 22.88308429465703, -105.50167050970899 22.958377386171065, -105.4534902165992 22.97729159273498, -105.43256982616995 23.02403150703234, -105.4091136308402 23.023667772290725, -105.41291733819097 23.07404503400422, -105.39231392337427 23.0840477393986, -105.3583975328299 23.073863166633416, -105.35427684986657 23.020212292245397, -105.32353021544782 22.941281853315225, -105.2978551908301 22.95419443664251, -105.16345753110282 22.9538307019009, -105.07628923764763 22.959468590395907, -105.00338484675783 22.976927857993367)))",2023,Total,1294124,1278605,1294124,15519,15519,1.21
13,,16,Michoacán,"POLYGON ((-101.94647203918724 20.343124593968625, -101.9601019905275 20.30584178295322, -101.93474394152236 20.297475883896105, -101.95154364898828 20.2707413803875, -101.93981555132339 20.227093211393857, -101.90780101445439 20.215089964920605, -101.9147744779308 20.194175217277817, -101.83489662356459 20.224728935573367, -101.7965425744443 20.212725689100115, -101.76040735461197 20.201813646851704, -101.72744189090528 20.211452617504467, -101.69384247597345 20.191810941457327, -101.68591808565935 20.218363577595127, -101.64788101215163 20.238187121013073, -101.62569271927212 20.266922165600555, -101.62727759733494 20.303295639761924, -101.56388247482208 20.320391172617768, -101.52330959641384 20.33239441909102, -101.50048735230921 20.311479671448232, -101.46023144951353 20.323482917921485, -101.45991447390097 20.323482917921485, -101.44501662011044 20.28965558695141, -101.45864657145071 20.26946830879185, -101.41997554671786 20.274378727803636, -101.39525144893784 20.248371693778257, -101.36133505839345 20.248917295890678, -101.36323691206884 20.19563015624427, -101.42029252233043 20.2016317794809, -101.42251135161837 20.163257764240655, -101.38922891229912 20.130339770124614, -101.40856442466554 20.122883207921532, -101.40254188802682 20.044862105845397, -101.32836959468676 20.03194952251811, -101.29191739924187 20.03595060467586, -101.23834852071849 20.032131389888917, -101.20316422772385 20.00721556008838, -101.20157934966102 20.025766031910678, -101.16068949564023 20.03995168683361, -101.19650773986 20.057047219689455, -101.17400247136793 20.09778551075019, -101.132478666122 20.060684567105593, -101.08049466566145 20.08287238634403, -101.01171095773498 20.08159931474838, -100.99269242098111 20.064685649263343, -101.0142467626355 20.045589575328624, -100.97018715248905 20.005215019009505, -101.00315261619573 19.95301908358794, -100.9590930060493 19.930831264349504, -100.94768188399698 19.962476186869896, -100.90901085926413 19.96211245212828, -100.83578949276176 19.934650479136447, -100.82469534632202 19.978298648130092, -100.79204685822788 19.955565226779235, -100.78000178495044 19.91555440520173, -100.74703632124374 19.912826394639627, -100.71660666243757 19.941379571856302, -100.66050197901367 19.96447672794877, -100.61992910060545 19.95702016574569, -100.60186149068927 19.98593707770398, -100.55780188054283 19.99157496619899, -100.5926691979249 19.966477269027646, -100.52705524612409 19.96574979954442, -100.53593056327588 19.92301096740481, -100.511840416721 19.95811136997053, -100.44844529420813 19.982663465029454, -100.36286187881575 19.98993815986173, -100.35810724462729 20.064685649263343, -100.38980480588373 20.080689977894345, -100.38092948873192 20.129794168012193, -100.35588841533934 20.182353838175374, -100.35525446411421 20.219091047078354, -100.32355690285777 20.252009041194395, -100.35081680553832 20.288382515355764, -100.307391146617 20.285290770052047, -100.26079573157004 20.267467767712976, -100.18155182842895 20.205087259526227, -100.19201202364357 20.175988480197134, -100.23607163379002 20.1432523534519, -100.19771758466973 20.129794168012193, -100.2015212920205 20.07577955888256, -100.13780919389507 20.044316503732976, -100.15302402329816 20.054319209127353, -100.15524285258611 20.00721556008838, -100.11593787662812 20.00594248849273, -100.13146968164378 19.98175412817542, -100.13051875480609 19.91610000731415, -100.09184773007324 19.859902989734834, -100.13432246215686 19.845353600070286, -100.14478265737148 19.764240752690434, -100.14985426717251 19.72750354378745, -100.19042714558076 19.699495968683195, -100.25857690228209 19.700223438166425, -100.26523339014594 19.662031290296987, -100.2468488046172 19.597468373660554, -100.22751329225078 19.557639419453857, -100.19676665783204 19.531632385428477, -100.20183826763306 19.499259993424857, -100.17806509669074 19.492712768075812, -100.20088734079538 19.492712768075812, -100.19549875538178 19.44615472114926, -100.23733953624027 19.40341588900965, -100.29344421966417 19.395049989952536, -100.31277973203059 19.362313863207305, -100.30675719539187 19.32684972589997, -100.31785134183161 19.317938224730433, -100.319753195507 19.26174120715112, -100.33813778103574 19.227004539327012, -100.37268812280524 19.19299534098613, -100.3615939763655 19.154621325745886, -100.38980480588373 19.14298181401425, -100.40914031825015 19.074963417332487, -100.41167612315067 19.06332390560085, -100.47919192862688 19.032042717822073, -100.52768919734922 19.010400500696058, -100.54353797797744 18.9371079502609, -100.6132726127416 18.886912555918208, -100.62246490550595 18.866907145129456, -100.70551251599781 18.795615135773172, -100.70361066232243 18.824350180360653, -100.748304223694 18.86781648198349, -100.77714900443736 18.85981431766799, -100.79046198016506 18.825441384585496, -100.79711846802891 18.74669281302613, -100.77334529708659 18.732507158103196, -100.78412246791378 18.687767784884713, -100.76225115064683 18.68031122268163, -100.75147397981965 18.633571308384273, -100.76478695554735 18.56100622743234, -100.74450051634324 18.518085527921926, -100.63736275929648 18.457705560814052, -100.59076734424953 18.41460299393283, -100.64275134471008 18.346220862509455, -100.68395817434345 18.386777286199383, -100.68776188169421 18.40896510543782, -100.71755758927526 18.399508002155862, -100.73689310164168 18.42678810777689, -100.7758811019871 18.437882017396106, -100.79331476067814 18.477165369490386, -100.82469534632202 18.474255491557475, -100.87382656626949 18.492078493896546, -100.92105593254158 18.445520446969994, -100.96670042075084 18.453704478656302, -100.97557573790264 18.48316699272701, -101.004420518646 18.49135102441332, -101.00949212844702 18.525542090125008, -101.08873603158811 18.505900414077868, -101.18794939832075 18.517539925809505, -101.21267349610078 18.536635999744224, -101.28114022841467 18.544638164059727, -101.36418783890653 18.51826739529273, -101.36957642432013 18.499716923470434, -101.41110022956606 18.510628965718844, -101.43804315663402 18.49135102441332, -101.48146881555535 18.490259820188477, -101.5014382791469 18.486986207513954, -101.58797262137696 18.52645142697904, -101.60540628006801 18.574464412872047, -101.63900569499982 18.602290120605495, -101.70335174435039 18.588286333053368, -101.713811939565 18.61011041755019, -101.77213545227686 18.60374505957195, -101.8437719407164 18.57428254550124, -101.8561339896064 18.559551288465887, -101.87959018493616 18.53918214293552, -101.88688062402514 18.477165369490386, -101.8605716481823 18.446066049082415, -101.8881485264754 18.40987444229185, -101.86183955063257 18.356223567903832, -101.86215652624513 18.28838703859288, -101.89702384362721 18.277111261602855, -101.90463125832875 18.247830614902952, -101.92903838049621 18.23128068415953, -101.96929428329187 18.233099357867598, -101.97816960044368 18.207092323842218, -102.03807799121834 18.20818352806706, -102.05836443042246 18.19490720999816, -102.13158579692482 18.188905586761535, -102.162015455731 18.164171624331804, -102.18452072422306 18.061598427196742, -102.17342657778332 17.98957894835723, -102.13792530917611 17.969755404939285, -102.13729135795099 17.94011102349777, -102.19212813892462 17.915558928438845, -102.31036004241112 17.969755404939285, -102.4900852147351 18.02013266665278, -102.60958502067186 18.048867711240263, -102.718624631394 18.061598427196742, -102.78899321738328 18.085059318030826, -102.98583507278575 18.171446319164076, -103.06317712225145 18.19436160788574, -103.11484414709943 18.193634138402512, -103.21057078209387 18.23182628627195, -103.29615419748625 18.24964928861102, -103.49204512605101 18.329489064395226, -103.53008219955873 18.38295807141244, -103.52976522394617 18.40532775802168, -103.57984737073133 18.50171746454931, -103.62961254190394 18.549912317813124, -103.71012434749528 18.597015966852098, -103.68603420094038 18.624296072473122, -103.73801820140095 18.68394857009777, -103.69871322544296 18.755604314195665, -103.63817088344318 18.783248154558308, -103.6245409321029 18.826168854068722, -103.64070668834368 18.867089012500262, -103.61978629791444 18.893096046525642, -103.58143224879416 18.876000513669798, -103.57255693164235 18.872181298882854, -103.55892698030209 18.90582676248212, -103.48887536992537 18.964751790623538, -103.48380376012433 18.979846782400507, -103.42072561322404 18.981665456108576, -103.39600151544401 18.967116066444028, -103.37729995430271 18.980028649771313, -103.33197244170601 18.973481424422268, -103.24860785560159 19.014401582853807, -103.22388375782157 19.023858686135764, -103.2048652210677 18.968389138039676, -103.1738016110364 18.936198613406866, -103.12498736670149 18.930196990170238, -103.04510951233527 19.032042717822073, -103.02514004874372 19.053139332835666, -102.99217458503703 19.05277559809405, -103.01563078036679 19.07878263211943, -103.019117512105 19.132251639136644, -102.98044648737215 19.11988465792178, -102.9604770237806 19.17389926705141, -102.9151495111839 19.179537155546424, -102.88408590115259 19.20572605694261, -102.82481146160305 19.20572605694261, -102.77314443675506 19.245191276407695, -102.75380892438864 19.255557716543684, -102.67076131389678 19.213000751774885, -102.63811282580265 19.262468676634345, -102.63811282580265 19.29502293600877, -102.61116989873469 19.323030511113025, -102.6013436547452 19.364496271656986, -102.54460502009617 19.433242137821974, -102.56869516665105 19.445427251666032, -102.54270316642078 19.47616283733239, -102.5763025813526 19.497805054458404, -102.57218189838927 19.511081372527304, -102.5826420936039 19.528358772753954, -102.65744833816908 19.48725674695161, -102.68946287503807 19.513263780976985, -102.71545487526835 19.498350656570825, -102.71640580210605 19.600378251593465, -102.77472931481789 19.62656715298965, -102.79311390034663 19.6623950250386, -102.78075185145661 19.701860244503685, -102.81086453465022 19.74077986185635, -102.81973985180203 19.77769893813014, -102.79438180279688 19.812617473325055, -102.74461663162427 19.81407241229151, -102.73130365589657 19.8988226070875, -102.78423858319482 19.95120040987987, -102.88250102308977 19.975752504938797, -102.90912697454517 19.970660218556205, -102.95128473101623 19.996485385210775, -102.99375946309985 19.983754669254296, -103.01563078036679 19.959566308936985, -103.05018112213631 19.996485385210775, -103.02101936578039 20.047226381665887, -103.03116258538245 20.06595872085899, -103.0324304878327 20.136523260732048, -102.99883107290088 20.12597495322525, -102.94431126753982 20.130885372237035, -102.92465877956083 20.136159525990433, -102.95413751152931 20.170896193814542, -102.87552755961335 20.15761987574564, -102.81657009567638 20.105969542436497, -102.81973985180203 20.137250730215275, -102.78455555880738 20.13743259758608, -102.73066970467144 20.166167642173562, -102.67963663104858 20.171259928556154, -102.68280638717422 20.20672406586349, -102.68502521646218 20.211998219616888, -102.67900267982345 20.226729476652242, -102.62733565497547 20.229639354585153, -102.61116989873469 20.268740839308624, -102.59120043514314 20.25855626654344, -102.52241672721667 20.275651799399284, -102.53129204436847 20.29492974070481, -102.43239565324839 20.34094218551894, -102.36868355512296 20.328029602191656, -102.34712921346858 20.3345768275407, -102.34712921346858 20.334940562282316, -102.29799799352111 20.35367290147542, -102.2536214077621 20.335486164394737, -102.2197050172177 20.351126758284124, -102.18008306564717 20.355309707812683, -102.09640150393018 20.384044752400165, -102.0108180885378 20.379316200759185, -102.02539896671577 20.34730754349718, -101.99021467372113 20.36058386156608, -101.94647203918724 20.343124593968625))",2023,Total,4950601,4901506,4950601,49095,49095,1.0
14,,14,Jalisco,"POLYGON ((-103.9259847396516 22.331662426370677, -103.90189459309671 22.23709139355112, -103.86322356836386 22.166708721048867, -103.82835625098178 22.287832390006226, -103.84547293406025 22.342756335989893, -103.81155654351588 22.376583666959966, -103.81028864106561 22.427324663415078, -103.78683244573585 22.477701925128574, -103.76908181143224 22.55572302720471, -103.72724103057375 22.574091631656202, -103.6619440543855 22.547357128147596, -103.61059400515008 22.559542241991654, -103.58523595614493 22.52535117627997, -103.57255693164235 22.43750923618026, -103.5944282489093 22.407137385255517, -103.60710727341187 22.338209651719723, -103.6353181029301 22.343301938102314, -103.63817088344318 22.295288952209308, -103.59949985871032 22.277647817241043, -103.63088044435419 22.238728199888378, -103.66131010316037 22.166708721048867, -103.69078883512886 22.128334705808623, -103.684132347265 22.109238631873904, -103.60457146851135 22.097780987513072, -103.58048132195647 22.125788562617327, -103.5383235654854 22.121423745717962, -103.51581829699333 22.10996610135713, -103.44988736957995 22.114330918256496, -103.42643117425018 22.139064880686227, -103.40899751555915 22.215449176425103, -103.33799497834474 22.245093557866618, -103.29932395361189 22.24891277265356, -103.29773907554906 22.298380697513025, -103.32816873435524 22.30729219868256, -103.35447771019808 22.279466490949112, -103.34306658814576 22.335117906416006, -103.36462092980014 22.3694908394985, -103.30566346586318 22.390405587141288, -103.28569400227161 22.413502743233757, -103.23244209936081 22.39313359770339, -103.21944609924567 22.41059286530085, -103.19884268442898 22.38040288174691, -103.16873000123537 22.384767698646275, -103.16873000123537 22.35457771509234, -103.2102538064813 22.32802507895454, -103.22261585537132 22.28346757310686, -103.19091829411488 22.29856256488383, -103.09899536647121 22.292379074276397, -103.07902590287966 22.258006141193903, -103.05747156122528 22.237636995663536, -103.05271692703683 22.2207233301785, -103.10596882994763 22.1914426834786, -103.10248209820942 22.153432402979966, -103.07712404920427 22.127607236325396, -103.12688922037688 22.103964478120506, -103.15414912305741 22.072319555600114, -103.10787068362302 22.063408054430578, -103.10628580556019 22.047039991057964, -103.11135741536123 22.01430386431273, -103.17253370858614 21.99648086197366, -103.20201244055463 21.998299535681728, -103.1925031721777 21.969746358465052, -103.26604151429262 21.972292501656348, -103.27903751440776 21.98884243239977, -103.33862892956986 21.94228438547322, -103.34528541743371 21.914094942998158, -103.38934502758016 21.898636216479577, -103.4191407351612 21.89609007328828, -103.4698568331715 21.839347453596545, -103.47049078439663 21.813340419571166, -103.5028222968782 21.83316396298911, -103.52627849220796 21.80497452051405, -103.57255693164235 21.803519581547597, -103.52913127272103 21.773147730622853, -103.50852785790435 21.739684134394395, -103.52691244343309 21.675484952499577, -103.5491007363126 21.649659785845003, -103.55512327295132 21.576549102780653, -103.59157546839621 21.588916083995517, -103.59316034645903 21.559089835183194, -103.64736317620753 21.57491229644339, -103.68666815216552 21.556361824621092, -103.69459254247963 21.52889985162926, -103.67272122521268 21.505438960795175, -103.70156600595604 21.466337476071704, -103.65877429825986 21.463427598138793, -103.66099312754781 21.441603513641972, -103.62422395649034 21.418506357549504, -103.58682083420776 21.392317456153318, -103.57160600480466 21.439784839933903, -103.53895751671054 21.44469525894569, -103.51486737015564 21.396318538311068, -103.51042971157975 21.354852777767107, -103.66352893244832 21.338120979652878, -103.72121849393503 21.307749128728133, -103.71646385974657 21.26810204189224, -103.66574776173627 21.290471728501483, -103.64102366395625 21.28447010526486, -103.6353181029301 21.197173767277572, -103.6245409321029 21.192990817749013, -103.61471468811341 21.158254149924907, -103.59569615135955 21.13279271801195, -103.55353839488849 21.116788389380947, -103.51138063841744 21.146250903451655, -103.50440717494102 21.127700431629357, -103.46922288194638 21.143341025518744, -103.41660493026069 21.137703137023735, -103.41850678393608 21.115151583043684, -103.36937556398861 21.052043605373708, -103.3471872711091 21.044223308429014, -103.2974220999365 21.06404685184696, -103.27745263634495 21.05131613589048, -103.25843409959108 21.08314292578168, -103.20993683086874 21.09405496803009, -103.12625526915176 21.054771615935813, -103.07490521991633 21.074231424612144, -103.05778853683785 21.09914725441268, -103.05842248806297 21.098419784929455, -103.09867839085865 21.13097404430388, -103.07173546379069 21.15334373091312, -103.08473146390583 21.194082021973855, -103.04986414652375 21.263191622880456, -103.02672492680655 21.242095007866862, -102.99692921922549 21.259736142835127, -102.94811497489059 21.21463303487503, -102.91071185260799 21.204994064222266, -102.89898375494312 21.23754832359669, -102.86379946194847 21.252825182744466, -102.83717351049306 21.303202444457963, -102.81593614445126 21.294290943288427, -102.7915290222838 21.327936406887694, -102.77060863185456 21.315751293043636, -102.72781692415836 21.35703518621679, -102.72940180222119 21.387407037141532, -102.6821724359491 21.33921218387772, -102.64286745999112 21.367219758981975, -102.6590332162319 21.409049254267547, -102.654595557656 21.447241402136985, -102.62479985007495 21.501437878637425, -102.63177331355136 21.534355872753466, -102.69675331412705 21.543085506552192, -102.71735672894374 21.57145681639806, -102.76522004644096 21.5963726461986, -102.80325711994868 21.66730092081327, -102.80515897362406 21.670938268229406, -102.76205029031532 21.692034883243, -102.74810336336249 21.715859508818696, -102.74556755846197 21.720042458347255, -102.69611936290192 21.728590224775175, -102.6910477531009 21.752414850350874, -102.63367516722676 21.767327974757034, -102.58327604482902 21.74386708392295, -102.55506521531079 21.74350334918134, -102.41971662874582 21.669301461892143, -102.38453233575117 21.651842194294687, -102.32589184742677 21.622015945482364, -102.29546218862059 21.653115265890335, -102.22731243191926 21.656752613306473, -102.21463340741668 21.694762893805102, -102.17818121197178 21.688215668456056, -102.14204599213944 21.7053112013119, -102.10495984546942 21.751687380867644, -102.06438696706118 21.79624488671532, -102.05297584500886 21.813340419571166, -102.03871194244347 21.853169373777867, -101.94171740499878 21.889360980568426, -101.88054111177385 21.91009386084041, -101.83806637969023 21.907183982907497, -101.83553057478971 21.94155691598999, -101.88592969718745 21.932645414820456, -101.89765779485234 21.95828871410422, -101.86247350185769 21.991388575591067, -101.86183955063257 22.028853253977278, -101.8019311598579 22.027762049752436, -101.777841013303 22.007211036851263, -101.75089808623504 22.014667599054345, -101.71095915905192 21.97392930799361, -101.6596091098165 21.94155691598999, -101.65105076827727 21.90772958501992, -101.57022198707337 21.91700482093107, -101.56261457237181 21.855351782227547, -101.53725652336666 21.810612409009064, -101.51063057191126 21.798791029906617, -101.5388414014295 21.777694414893023, -101.58575379208901 21.778785619117865, -101.58004823106286 21.736228654349063, -101.55785993818336 21.734955582753415, -101.59367818240312 21.631654916135126, -101.58638774331415 21.60783029055943, -101.62283993875904 21.544722312889455, -101.64090754867522 21.528717984258453, -101.58924052382721 21.46470066973444, -101.5708559382985 21.418506357549504, -101.59684793852877 21.4210525007408, -101.6792615977955 21.39322679300735, -101.6428094023506 21.354852777767107, -101.64597915847624 21.3281182742585, -101.64344335357572 21.29938322967102, -101.68655203688448 21.29410907591762, -101.76864872053865 21.257735601756252, -101.77372033033967 21.21972532125762, -101.7876672572925 21.15643547621684, -101.83362872111434 21.13733940228212, -101.81777994048612 21.10678568398657, -101.87166579462206 21.095328039625738, -101.88688062402514 21.061136973914053, -101.90875194129208 20.99839273098569, -101.93727974642287 20.95565389884608, -102.05487769868425 20.846351608991167, -102.0802357476894 20.827983004539675, -102.08752618677838 20.778878814421827, -102.07389623543811 20.776514538601337, -102.06755672318683 20.771604119589554, -102.06438696706118 20.738686125473514, -102.03459125948014 20.741959738148037, -102.01430482027601 20.7170439083475, -102.01937643007705 20.67612374991596, -101.96802638084162 20.663574901330286, -101.95154364898828 20.60683228163855, -101.96897730767931 20.56245664316168, -101.9841921370824 20.53481280279904, -102.00955018608755 20.544997375564222, -102.06121721093554 20.44478845424965, -102.06406999144862 20.4407873720919, -102.09640150393018 20.384044752400165, -102.18008306564717 20.355309707812683, -102.2197050172177 20.351126758284124, -102.2536214077621 20.335486164394737, -102.29799799352111 20.35367290147542, -102.34712921346858 20.334940562282316, -102.34712921346858 20.3345768275407, -102.36868355512296 20.328029602191656, -102.43239565324839 20.34094218551894, -102.53129204436847 20.29492974070481, -102.52241672721667 20.275651799399284, -102.59120043514314 20.25855626654344, -102.61116989873469 20.268740839308624, -102.62733565497547 20.229639354585153, -102.67900267982345 20.226729476652242, -102.68502521646218 20.211998219616888, -102.68280638717422 20.20672406586349, -102.67963663104858 20.171259928556154, -102.73066970467144 20.166167642173562, -102.78455555880738 20.13743259758608, -102.81973985180203 20.137250730215275, -102.81657009567638 20.105969542436497, -102.87552755961335 20.15761987574564, -102.95413751152931 20.170896193814542, -102.92465877956083 20.136159525990433, -102.94431126753982 20.130885372237035, -102.99883107290088 20.12597495322525, -103.0324304878327 20.136523260732048, -103.03116258538245 20.06595872085899, -103.02101936578039 20.047226381665887, -103.05018112213631 19.996485385210775, -103.01563078036679 19.959566308936985, -102.99375946309985 19.983754669254296, -102.95128473101623 19.996485385210775, -102.90912697454517 19.970660218556205, -102.88250102308977 19.975752504938797, -102.78423858319482 19.95120040987987, -102.73130365589657 19.8988226070875, -102.74461663162427 19.81407241229151, -102.79438180279688 19.812617473325055, -102.81973985180203 19.77769893813014, -102.81086453465022 19.74077986185635, -102.78075185145661 19.701860244503685, -102.79311390034663 19.6623950250386, -102.77472931481789 19.62656715298965, -102.71640580210605 19.600378251593465, -102.71545487526835 19.498350656570825, -102.68946287503807 19.513263780976985, -102.65744833816908 19.48725674695161, -102.5826420936039 19.528358772753954, -102.57218189838927 19.511081372527304, -102.5763025813526 19.497805054458404, -102.54270316642078 19.47616283733239, -102.56869516665105 19.445427251666032, -102.54460502009617 19.433242137821974, -102.6013436547452 19.364496271656986, -102.61116989873469 19.323030511113025, -102.63811282580265 19.29502293600877, -102.63811282580265 19.262468676634345, -102.67076131389678 19.213000751774885, -102.75380892438864 19.255557716543684, -102.77314443675506 19.245191276407695, -102.82481146160305 19.20572605694261, -102.88408590115259 19.20572605694261, -102.9151495111839 19.179537155546424, -102.9604770237806 19.17389926705141, -102.98044648737215 19.11988465792178, -103.019117512105 19.132251639136644, -103.01563078036679 19.07878263211943, -102.99217458503703 19.05277559809405, -103.02514004874372 19.053139332835666, -103.04510951233527 19.032042717822073, -103.12498736670149 18.930196990170238, -103.1738016110364 18.936198613406866, -103.2048652210677 18.968389138039676, -103.22388375782157 19.023858686135764, -103.24860785560159 19.014401582853807, -103.33197244170601 18.973481424422268, -103.37729995430271 18.980028649771313, -103.39600151544401 18.967116066444028, -103.42072561322404 18.981665456108576, -103.48380376012433 18.979846782400507, -103.48887536992537 18.964751790623538, -103.48887536992537 19.027314166181093, -103.52279176046976 19.065870048792146, -103.52374268730745 19.113883034685152, -103.49775068707717 19.177354747096743, -103.51455039454308 19.21718370130344, -103.50947878474204 19.241553928991557, -103.50662600422896 19.29229492544667, -103.48633956502485 19.33776176814838, -103.5151843457682 19.351765555700506, -103.53800658987284 19.388139029861875, -103.56907019990415 19.406143899571752, -103.61566561495111 19.47488976573674, -103.61281283443803 19.488893553288868, -103.61820141985162 19.512354444122952, -103.6904718595163 19.492530900705006, -103.716146884134 19.456339293914443, -103.82138278750537 19.410872451212732, -103.83469576323307 19.43978936317102, -103.85466522682462 19.430877862001484, -103.88921556859414 19.46343212137591, -103.89967576380876 19.434515209417622, -103.96497273999702 19.454156885464762, -104.06196727744171 19.497623187087598, -104.07147654581864 19.48361939953547, -104.07211049704377 19.482164460569017, -104.0870083508343 19.441789904249895, -104.07115957020608 19.43524267890085, -104.0904950825725 19.39304944887366, -104.13328679026868 19.353584229408575, -104.12282659505406 19.32048436792173, -104.22330786423696 19.301570161357816, -104.24803196201698 19.312118468864615, -104.31491381626806 19.279382342119384, -104.34375859701142 19.289566914884567, -104.40144815849813 19.26683349353371, -104.40018025604788 19.289021312772146, -104.43948523200585 19.278109270523736, -104.49051830562871 19.23264242782202, -104.52316679372284 19.260286268184664, -104.55486435497927 19.236461642608965, -104.57673567224622 19.18081022714207, -104.60050884318854 19.178264083950776, -104.59004864797392 19.150074641475715, -104.6756320633663 19.185356911412242, -104.69021294154425 19.176445410242707, -104.68609225858091 19.207908465392293, -104.77547938132406 19.23900778580026, -104.8106636743187 19.234824836271706, -104.78879235705176 19.28356529164794, -104.82714640617205 19.30775365196525, -104.88134923592055 19.286657036951656, -104.93681996811931 19.310845397268967, -105.03222962750118 19.389230234086718, -105.02557313963733 19.437243219979724, -105.07343645713455 19.47088868357899, -105.08928523776277 19.560185562645152, -105.11083957941715 19.583646453479236, -105.13492972597203 19.57600802390535, -105.2205131413644 19.64566322692437, -105.26203694661034 19.679490557894443, -105.34349967903937 19.803524104784714, -105.40879665522763 19.87918093104036, -105.5051572414472 20.011580376987745, -105.5485829003685 20.094875632817278, -105.54351129056748 20.18126263395053, -105.5593600711957 20.23218549777645, -105.65635460864038 20.317663162055666, -105.68710124305913 20.367676689027547, -105.69470865776067 20.40968805168393, -105.65318485251474 20.428965992989454, -105.61451382778189 20.47115922301664, -105.52956436361464 20.49207397065943, -105.45824485078766 20.495347583333952, -105.32574904473577 20.51226124881899, -105.25791626364699 20.5577280915207, -105.23255821464186 20.61828992599938, -105.24523723914443 20.653390328565102, -105.28137245897676 20.6719408003874, -105.24428631230673 20.703221988166177, -105.23509401954236 20.747415759272243, -105.19737392164721 20.777060140713758, -105.17328377509232 20.76778490480261, -105.17138192141692 20.821072044449014, -105.13905040893536 20.8818157462985, -105.08833431092508 20.923099639471655, -105.04776143251684 20.93437541646168, -105.0392030909776 20.91291506670647, -104.98912094419244 20.921280965763586, -104.96883450498831 20.909095851919528, -104.83570474771129 21.019307478628477, -104.79956952787894 21.01567013121234, -104.73173674679018 21.01221465116701, -104.72951791750222 20.983115871837914, -104.6791187951045 20.957108837812534, -104.68102064877988 20.943832519743637, -104.62903664831933 20.924190843696497, -104.61889342871727 20.92382710895488, -104.59068259919904 20.934557283832486, -104.54281928170182 20.91200572985244, -104.50351430574385 20.841804924720996, -104.4505793784456 20.80361277685156, -104.39669352430965 20.7808793555007, -104.35073206048783 20.725409807404613, -104.28733693797496 20.687399526905985, -104.28226532817393 20.62883823350618, -104.25722425478135 20.603558668964027, -104.24771498640442 20.68994567009728, -104.24771498640442 20.726501011629455, -104.28289927939906 20.783425498691997, -104.29748015757701 20.770694782735518, -104.32822679199576 20.79815675572735, -104.37577313388041 20.784152968175224, -104.35041508487527 20.811614941167058, -104.36246015815271 20.840713720496154, -104.29240854777599 20.848534017440848, -104.29018971848804 20.887999236905934, -104.25976005968187 20.893818992771752, -104.2052402543208 20.95965498100383, -104.23345108383901 20.968566482173365, -104.24105849854057 21.021671754448967, -104.22774552281287 21.05077053377806, -104.21062883973438 21.13042844219146, -104.21950415688619 21.17644088700559, -104.20397235187053 21.192263348265787, -104.16086366856179 21.1846249186919, -104.100321326562 21.2006292473229, -104.0717935214312 21.188444133478843, -104.03565830159887 21.195900695681924, -104.0175906916827 21.22609067923586, -103.97543293521164 21.251188376407207, -103.91774337372493 21.23081923087684, -103.8619556659136 21.248824100586717, -103.81853000699229 21.249005967957523, -103.80363215320176 21.300110699154246, -103.74942932345326 21.336666040686424, -103.74562561610249 21.363036809453416, -103.76432717724379 21.410322325863195, -103.72121849393503 21.425962919752585, -103.75006327467838 21.475430844612045, -103.780175957872 21.49998293967097, -103.80173029952638 21.489434632164173, -103.85149547069898 21.515441666189552, -103.85656708050001 21.552360742463343, -103.8914343978821 21.568365071094345, -103.9234489347511 21.589643553478744, -103.90791712973544 21.61874233280784, -103.9304223982275 21.641657621529504, -103.89048347104439 21.699309578075272, -103.93390912996571 21.7478681660807, -103.92249800791339 21.770783454802363, -103.98494220358857 21.77260212851043, -104.05245800906478 21.79460808037806, -104.1304340097556 21.790425130849503, -104.19668191278156 21.85062323058657, -104.1998516689072 21.894271399580212, -104.17385966867693 21.970837562689894, -104.19319518104335 21.985386952354443, -104.2451791815039 21.966836480532145, -104.2939934258388 22.0028462199519, -104.32759284077063 21.975384246960065, -104.36372806060297 21.97392930799361, -104.36499596305323 22.112512244548427, -104.32854376760832 22.24563915997904, -104.29557830390164 22.276920347757816, -104.29240854777599 22.344393142327156, -104.25627332794366 22.349121693968133, -104.25437147426827 22.392769862961778, -104.208726986059 22.422414244403292, -104.16466737591256 22.39149679136613, -104.1722747906141 22.440237246742363, -104.1998516689072 22.456241575373365, -104.19478005910617 22.50389082652476, -104.16530132713768 22.513529797177522, -104.1136343022897 22.496434264321678, -104.12092474137867 22.515530338256397, -104.07940093613274 22.533171473224662, -104.05182405783965 22.46642614813855, -104.09461576553583 22.35494144983395, -104.04897127732657 22.37640179958916, -104.02361322832142 22.364398553115908, -104.004277715955 22.40986539581762, -103.96053508142111 22.433144419280897, -103.93327517874059 22.489159569489406, -104.00554561840525 22.53662695326999, -103.972263179086 22.544992852327105, -104.01537186239474 22.595915716153023, -104.02519810638424 22.652112733732338, -104.01537186239474 22.66866266447576, -104.07306142388146 22.693032892163878, -104.02614903322194 22.743228286506568, -103.90918503218569 22.75013924659723, -103.8540312755995 22.729770101066862, -103.780175957872 22.729951968437668, -103.75481790886685 22.71958552830168, -103.77383644562072 22.611192575300798, -103.85561615366231 22.574273499027008, -103.87558561725388 22.521531961493025, -103.86258961713874 22.501708418075076, -103.88572883685593 22.473518975600015, -103.86639332448951 22.41495768220021, -103.9259847396516 22.331662426370677))",2023,Total,8735511,8647986,8735511,87525,87525,1.01
15,,7,Chiapas,"POLYGON ((-91.81434658356783 17.90028206929107, -91.77947926618575 17.849722940206767, -91.78803760772499 17.807165975437965, -91.78296599792395 17.77733972662564, -91.8216370226568 17.73187288392393, -91.73858941216496 17.702592237224028, -91.67836404577773 17.67131104944525, -91.64634950890873 17.617842042428038, -91.66314921637463 17.61256788867464, -91.63842511859461 17.579286159816988, -91.63525536246897 17.533455582373662, -91.6501532162595 17.495263434504224, -91.6821677531285 17.469256400478844, -91.67202453352644 17.443976835936695, -91.62035750867845 17.43142798735102, -91.55918121545352 17.40032866694305, -91.55791331300327 17.42233461881068, -91.51004999550605 17.391962767885936, -91.41971194592521 17.374139765546865, -91.41685916541213 17.345404720959383, -91.38389370170545 17.30975871628124, -91.42541750695138 17.302120286707353, -91.43968140951677 17.25101555551063, -91.42763633623932 17.216642622428136, -91.35504892096209 17.190635588402756, -91.34934335993593 17.160263737478015, -91.32430228654334 17.182815291458063, -91.27802384710895 17.17899607667112, -91.26027321280534 17.102975515673858, -91.22635682226097 17.094064014504323, -91.2171645294966 17.064237765692, -91.17564072425067 17.01567917768657, -91.12143789450217 17.001675390134444, -91.1201699920519 16.977487029817134, -91.06438228424058 16.925109227024763, -91.06660111352853 16.903285142527942, -91.00700969836643 16.886189609672098, -90.98165164936128 16.866547933624958, -90.9841874542618 16.899102192999383, -90.95819545403153 16.897101651920508, -90.97467818588487 16.86709353573738, -90.93442228308919 16.860000708275912, -90.91762257562328 16.82035362144002, -90.88497408752916 16.825082173080997, -90.85549535556068 16.798165802201584, -90.80446228193782 16.79889327168481, -90.80287740387499 16.77597798296315, -90.76388940352957 16.763611001748284, -90.70936959816851 16.721781506462708, -90.65738559770796 16.637940648520754, -90.65548374403257 16.592291938448234, -90.62600501206408 16.5753782729632, -90.64660842688076 16.5621019548943, -90.64565750004307 16.519544990125496, -90.61871457297511 16.522091133316792, -90.58543213365584 16.469531463153615, -90.47766042538397 16.456800747197136, -90.4862187669232 16.423882753081095, -90.42345759563547 16.425155824676743, -90.40126930275596 16.39132849370667, -90.39778257101776 16.339678160397526, -90.4408912543265 16.28075313225611, -90.4221896931852 16.26165705832139, -90.45388725444164 16.250926883443785, -90.45293632760395 16.18600023206574, -90.42440852247316 16.16235747386085, -90.45578910811703 16.093429740325057, -90.4408912543265 16.074151799019532, -90.79178325743524 16.074151799019532, -90.96136521015717 16.073788064277917, -91.16613145587374 16.074333666390338, -91.29704238386282 16.074333666390338, -91.38167487241749 16.074333666390338, -91.73161594868853 16.073788064277917, -91.92180131622715 15.75133721583738, -91.98995107292848 15.635669568004225, -92.12910336684423 15.399969455438553, -92.20993214804814 15.26120465151293, -92.18425712343043 15.227377320542857, -92.16301975738861 15.201006551775864, -92.10786600080242 15.131715083498456, -92.05936873208007 15.070243912165742, -92.09835673242549 15.009682077687062, -92.13100522051961 15.013137557732392, -92.14875585482322 14.988949197415081, -92.14907283043578 14.868371130570143, -92.18140434291735 14.847456382927355, -92.17791761117914 14.804899418158554, -92.15541234268707 14.73069753086936, -92.14590307431014 14.663406603670827, -92.16967624525246 14.639218243353517, -92.18235526975504 14.578292674133223, -92.22673185551405 14.532098361948284, -92.3196057099954 14.618121628339923, -92.40930980835111 14.695960863045253, -92.4663654186127 14.757432034377967, -92.67652024974286 14.97294486878408, -92.73262493316675 15.030778692700656, -92.93105166663203 15.231196535329799, -93.12377283907115 15.408880956608089, -93.33361069458876 15.591839531639774, -93.51428679375043 15.734423550352343, -93.70193635638853 15.866822996299726, -93.78688582055577 15.91901893172129, -93.91969860222024 15.983763715728529, -94.00021040781158 16.002859789663248, -94.03602865203135 16.022137730968772, -94.10069167699447 16.138896583026767, -94.10291050628243 16.142533930442905, -94.10956699414628 16.178907404604274, -94.04870767653392 16.215826480878064, -94.0328588959057 16.275842713244323, -94.05092650582188 16.329493587632342, -94.10259353066986 16.407332822337672, -94.13936270172732 16.461893033579727, -94.13365714070117 16.475896821131855, -94.04553792040828 16.694865135583296, -93.86771460175969 17.13680284664393, -93.8613750895084 17.163719217523344, -93.82714172335145 17.172448851322073, -93.80400250363425 17.224826654114445, -93.77262191799038 17.245741401757233, -93.66294835604312 17.256107841893222, -93.66453323410593 17.28611595807635, -93.60811157506947 17.314851002663833, -93.55454269654611 17.388143553098992, -93.51111703762479 17.447977918094445, -93.48385713494426 17.550732982600312, -93.45247654930039 17.546004430959336, -93.44772191511191 17.582196037749895, -93.41665830508062 17.59801849901009, -93.36055362165672 17.66494569146701, -93.3599196704316 17.722233913271168, -93.3909832804629 17.773156777097086, -93.35294620695518 17.76369967381513, -93.34311996296569 17.78734243202002, -93.3358295238767 17.845721858049018, -93.3500934264421 17.882459066952, -93.3412181092903 17.929380848620166, -93.29842640159411 17.947385718330043, -93.2816266941282 17.981394916670922, -93.24137079133253 17.95047746363376, -93.2185485472279 17.956115352128773, -93.14501020511297 17.932108859182268, -93.09144132658959 17.886823883851363, -93.13201420499783 17.852269083398063, -93.11584844875705 17.822260967214934, -93.09524503394036 17.841357041149653, -93.04040825296673 17.840993306408038, -93.0131483502862 17.79880007638085, -93.03343478949031 17.77006503179337, -93.05815888727034 17.720233372192293, -93.04199313102956 17.687315378076253, -93.04452893593006 17.62002445087772, -93.00459000874696 17.578922425075373, -93.0042730331344 17.555279666870483, -92.9446816179723 17.483078320660166, -92.92059147141741 17.502719996707306, -92.85973215380506 17.500355720886816, -92.83374015357478 17.481805249064518, -92.81947625100938 17.43270105894667, -92.85656239767941 17.418697271394542, -92.78587683607756 17.414332454495177, -92.75386229920856 17.34340417988051, -92.73547771367983 17.347223394667452, -92.7348437624547 17.347223394667452, -92.67778815219312 17.379777654041877, -92.65940356666438 17.444704305419922, -92.59410659047613 17.492171689200507, -92.59727634660177 17.520179264304762, -92.56304298044482 17.54564069621772, -92.53007751673813 17.550005513117085, -92.52025127274864 17.573102669209554, -92.47936141872783 17.574921342917623, -92.43593575980651 17.570010923905837, -92.35066932002671 17.617842042428038, -92.34908444196388 17.65639792503909, -92.35035234441415 17.702592237224028, -92.3284810271472 17.71350427947244, -92.27459517301126 17.69222579708804, -92.23116951408994 17.74405799776799, -92.17189507454042 17.78661496253679, -92.15192561094887 17.764427143298356, -92.13068824490705 17.76588208226481, -92.13988053767142 17.80971211862926, -92.12054502530499 17.795708331077133, -92.09043234211137 17.856633900297428, -92.05810082962981 17.84663119490305, -92.07236473219521 17.87482063737811, -92.01562609754619 17.897554058728968, -91.98646434119027 17.923015490641927, -91.93891799930562 17.902282610369944, -91.94430658471921 17.86281739090486, -91.9132429746879 17.89973646717865, -91.84953087656247 17.882822801693614, -91.81434658356783 17.90028206929107))",2023,Total,5946352,5862882,5946352,83470,83470,1.42
16,,27,Tabasco,"POLYGON ((-92.33165078327285 18.460251704005348, -92.17601575750375 18.458251162926473, -92.17157809892785 18.338946167677182, -92.17918551362939 18.26874536254574, -92.14907283043578 18.210184069145935, -92.16080092810066 18.155260123162268, -92.10818297641498 18.093607084458746, -92.04161809777646 18.09797190135811, -92.01309029264567 18.05141385443156, -91.9791739021013 18.04286608800364, -91.96681185321128 18.015767849753416, -91.9097562429497 18.01376730867454, -91.86728151086608 17.98321359037899, -91.80452033957833 17.97230154813058, -91.77123790025908 17.944293973026326, -91.73890638777752 17.93592807396921, -91.67202453352644 17.89446231342525, -91.63874209420717 17.873911300524078, -91.6127500939769 17.912830917876743, -91.62194238674127 17.942657166689067, -91.61116521591408 18.09524389079601, -91.57249419118124 18.141983805093368, -91.53445711767351 18.146166754621927, -91.51575555653221 18.169991380197622, -91.51638950775734 18.130526160732536, -91.43746258022881 18.083786246435178, -91.3851616041557 18.064144570388038, -91.32842296950668 18.06287149879239, -91.21779848072173 17.974847691321877, -91.14457711421936 17.975029558692682, -91.1201699920519 17.963390046961045, -90.98799116161257 17.962298842736203, -90.987674186 17.815350007124273, -90.98799116161257 17.423062088293907, -90.98735721038744 17.25101555551063, -91.43968140951677 17.25101555551063, -91.42541750695138 17.302120286707353, -91.38389370170545 17.30975871628124, -91.41685916541213 17.345404720959383, -91.41971194592521 17.374139765546865, -91.51004999550605 17.391962767885936, -91.55791331300327 17.42233461881068, -91.55918121545352 17.40032866694305, -91.62035750867845 17.43142798735102, -91.67202453352644 17.443976835936695, -91.6821677531285 17.469256400478844, -91.6501532162595 17.495263434504224, -91.63525536246897 17.533455582373662, -91.63842511859461 17.579286159816988, -91.66314921637463 17.61256788867464, -91.64634950890873 17.617842042428038, -91.67836404577773 17.67131104944525, -91.73858941216496 17.702592237224028, -91.8216370226568 17.73187288392393, -91.78296599792395 17.77733972662564, -91.78803760772499 17.807165975437965, -91.77947926618575 17.849722940206767, -91.81434658356783 17.90028206929107, -91.84953087656247 17.882822801693614, -91.9132429746879 17.89973646717865, -91.94430658471921 17.86281739090486, -91.93891799930562 17.902282610369944, -91.98646434119027 17.923015490641927, -92.01562609754619 17.897554058728968, -92.07236473219521 17.87482063737811, -92.05810082962981 17.84663119490305, -92.09043234211137 17.856633900297428, -92.12054502530499 17.795708331077133, -92.13988053767142 17.80971211862926, -92.13068824490705 17.76588208226481, -92.15192561094887 17.764427143298356, -92.17189507454042 17.78661496253679, -92.23116951408994 17.74405799776799, -92.27459517301126 17.69222579708804, -92.3284810271472 17.71350427947244, -92.35035234441415 17.702592237224028, -92.34908444196388 17.65639792503909, -92.35066932002671 17.617842042428038, -92.43593575980651 17.570010923905837, -92.47936141872783 17.574921342917623, -92.52025127274864 17.573102669209554, -92.53007751673813 17.550005513117085, -92.56304298044482 17.54564069621772, -92.59727634660177 17.520179264304762, -92.59410659047613 17.492171689200507, -92.65940356666438 17.444704305419922, -92.67778815219312 17.379777654041877, -92.7348437624547 17.347223394667452, -92.73547771367983 17.347223394667452, -92.75386229920856 17.34340417988051, -92.78587683607756 17.414332454495177, -92.85656239767941 17.418697271394542, -92.81947625100938 17.43270105894667, -92.83374015357478 17.481805249064518, -92.85973215380506 17.500355720886816, -92.92059147141741 17.502719996707306, -92.9446816179723 17.483078320660166, -93.0042730331344 17.555279666870483, -93.00459000874696 17.578922425075373, -93.04452893593006 17.62002445087772, -93.04199313102956 17.687315378076253, -93.05815888727034 17.720233372192293, -93.03343478949031 17.77006503179337, -93.0131483502862 17.79880007638085, -93.04040825296673 17.840993306408038, -93.09524503394036 17.841357041149653, -93.11584844875705 17.822260967214934, -93.13201420499783 17.852269083398063, -93.09144132658959 17.886823883851363, -93.14501020511297 17.932108859182268, -93.2185485472279 17.956115352128773, -93.24137079133253 17.95047746363376, -93.2816266941282 17.981394916670922, -93.29842640159411 17.947385718330043, -93.3412181092903 17.929380848620166, -93.3500934264421 17.882459066952, -93.3358295238767 17.845721858049018, -93.34311996296569 17.78734243202002, -93.35294620695518 17.76369967381513, -93.3909832804629 17.773156777097086, -93.3599196704316 17.722233913271168, -93.36055362165672 17.66494569146701, -93.41665830508062 17.59801849901009, -93.44772191511191 17.582196037749895, -93.45247654930039 17.546004430959336, -93.48385713494426 17.550732982600312, -93.51111703762479 17.447977918094445, -93.55454269654611 17.388143553098992, -93.60811157506947 17.314851002663833, -93.64139401438874 17.31794274796755, -93.63568845336258 17.338311893497917, -93.69527986852468 17.387416083615765, -93.65312211205362 17.41942474087777, -93.62427733131027 17.49326289342535, -93.62174152640975 17.5450950941053, -93.64900142909028 17.555279666870483, -93.73173206396957 17.62529860463112, -93.74694689337267 17.66858303888315, -93.77230494237781 17.692407664458845, -93.8052704060845 17.689134051784322, -93.88102757748739 17.725871260687306, -93.86961645543506 17.74005691561024, -93.92223440712075 17.74642227358848, -93.94917733418872 17.768973827568527, -93.95836962695309 17.82062416087767, -93.9786560661572 17.851723481285642, -94.02651938365442 17.840629571666426, -94.03729655448161 17.87081955522036, -94.083574993916 17.86972835099552, -94.09023148177985 17.96830046597283, -94.0613867010365 17.987032805165935, -94.08389196952857 18.00649261384227, -94.07438270115163 18.059052284005446, -94.10132562821961 18.12852561965366, -94.10164260383218 18.172537523388918, -94.12034416497346 18.16489909381503, -94.13017040896297 18.198726424785104, -94.13048738457553 18.21273021233723, -93.85693743093249 18.29875347872887, -93.64234494122643 18.373500968130482, -93.52664884264044 18.40769203384217, -93.39447001220111 18.43369906786755, -93.09682991200319 18.442792436407892, -93.0308989845898 18.431152924676255, -92.9028408371138 18.441519364812244, -92.81472161682092 18.474982961040702, -92.75037556747036 18.525542090125008, -92.68729742057005 18.61920378609053, -92.64545663971155 18.611383489145837, -92.573820151272 18.622841133506668, -92.46921819912578 18.650848708610923, -92.46604844300013 18.61647577552843, -92.42610951581702 18.55700514527459, -92.41438141815215 18.48734994225557, -92.36208044207902 18.461524775600996, -92.33165078327285 18.460251704005348))",2023,Total,2454787,2447193,2454787,7594,7594,0.31
17,,20,Oaxaca,"POLYGON ((-96.6282552115826 18.631752634676204, -96.58419560143615 18.60210825323469, -96.58419560143615 18.601744518493074, -96.56105638171896 18.587740730940947, -96.50843843003327 18.589559404649016, -96.45708838079784 18.57028146334349, -96.42031920974038 18.507900955156742, -96.40288555104934 18.439700691104175, -96.35248642865162 18.410238177033467, -96.32015491617005 18.3580422416119, -96.31983794055749 18.3580422416119, -96.30177033064132 18.318031420034394, -96.2947968671649 18.312211664168576, -96.27324252551053 18.30057215243694, -96.28877433052618 18.2623800045675, -96.21777179331177 18.161807348511314, -96.17149335387737 18.18635944357024, -96.17973471980405 18.140528866126914, -96.12204515831733 18.14307500931821, -96.08400808480961 18.161625481140508, -96.06657442611856 18.13161736495738, -96.0209299379093 18.137800855564812, -96.0164922793334 18.136527783969164, -95.9908172547157 18.15125904100452, -95.98257588878901 18.1454392851387, -95.97940613266337 18.14653048936354, -95.9588027178467 18.152895847341778, -95.91854681505102 18.151440908375324, -95.9026980344228 18.135618447115128, -95.8519819364125 18.130526160732536, -95.83359735088378 18.129071221766083, -95.82440505811941 18.080876368502267, -95.79999793595195 17.949749994150533, -95.8484952046743 17.8479042664987, -95.85927237550149 17.84444878645337, -95.84912915589942 17.82753512096833, -95.86719676581559 17.773156777097086, -95.89128691237049 17.766791419118846, -95.89540759533382 17.704410910932097, -95.8031676920776 17.629117819418063, -95.77337198449655 17.623843665664666, -95.80348466769016 17.606930000179627, -95.74484417936576 17.585833385166033, -95.7026864228947 17.518724325338308, -95.64563081263312 17.54691376781337, -95.59871842197359 17.534546786598504, -95.57272642174331 17.54855057415063, -95.52993471404713 17.570738393389064, -95.48460720145043 17.601837713797035, -95.477633737974 17.587833926244908, -95.42628368873858 17.64675895438633, -95.40631422514703 17.64366720908261, -95.35116046856083 17.67822200953591, -95.33404378548236 17.675130264232195, -95.29600671197464 17.722233913271168, -95.26494310194333 17.717869096371803, -95.23895110171306 17.739329446127012, -95.19045383299071 17.691862062346424, -95.18728407686507 17.654761118701828, -95.25384895550359 17.6407573311497, -95.2785730532836 17.615114031865936, -95.25321500427845 17.601292111684614, -95.2047177355561 17.53872973612706, -95.12230407628937 17.431973589463443, -95.0766595880801 17.372866693951217, -94.972691587159 17.331400933407256, -94.8909118791174 17.31103178787689, -94.9096134402587 17.26792922099567, -94.9229264159864 17.193545466335667, -94.82371304925375 17.18863504732388, -94.74351821927497 17.18463396516613, -94.08737870126677 17.149351695229605, -93.86771460175969 17.13680284664393, -94.04553792040828 16.694865135583296, -94.13365714070117 16.475896821131855, -94.13936270172732 16.461893033579727, -94.10259353066986 16.407332822337672, -94.05092650582188 16.329493587632342, -94.0328588959057 16.275842713244323, -94.04870767653392 16.215826480878064, -94.10956699414628 16.178907404604274, -94.10291050628243 16.142533930442905, -94.10069167699447 16.138896583026767, -94.03602865203135 16.022137730968772, -94.00021040781158 16.002859789663248, -94.20244084862763 16.09670335299958, -94.38406787462701 16.157992656961486, -94.54033685162123 16.19181998793156, -94.68456075533801 16.208369918674983, -94.73939753631164 16.20782431656256, -94.75651421939011 16.21018859238305, -94.83195441518043 16.214553409282416, -94.92387734282408 16.207642449191756, -95.07000310021625 16.183454088874445, -95.13910378375529 16.188546375257037, -95.15209978387043 16.167995362355864, -95.2332455406869 16.1583563917031, -95.28015793134642 16.115617559563493, -95.33879841967082 16.087791851830044, -95.37842037124136 16.046326091286083, -95.36796017602674 16.020864659373125, -95.42691763996372 15.996858166426621, -95.43547598150295 15.976125286154641, -95.51376895780635 15.963758304939775, -95.56765481194229 15.957938549073956, -95.66116261764877 15.913017308484665, -95.71219569127163 15.90756128736046, -95.76608154540757 15.896467377741242, -95.77622476500963 15.871915282682318, -95.8795588147056 15.851182402410338, -96.00349627921827 15.808079835529115, -96.04533706007676 15.788620026852783, -96.12172818270477 15.760612451748528, -96.13187140230683 15.739333969364127, -96.23742428129076 15.682409482301583, -96.33346789189775 15.68786550342579, -96.35977686774059 15.682773217043199, -96.43394916108065 15.694958330887257, -96.49449150308044 15.658221121984274, -96.52460418627405 15.662404071512832, -96.5543998938551 15.658221121984274, -96.70496330982317 15.71787361960892, -96.85235696966559 15.737333428285252, -96.93001599474385 15.780981597278895, -97.0159163857488 15.805897427079433, -97.04856487384292 15.828267113688675, -97.06219482518318 15.860093903579873, -97.10308467920399 15.868641670007795, -97.15601960650224 15.903378337831903, -97.21053941186331 15.922656279137428, -97.27393453437618 15.938478740397624, -97.35793307170573 15.944662231005056, -97.36839326692035 15.936660066689555, -97.47965170693044 15.9537555995454, -97.53131873177843 15.969396193434786, -97.56555209793538 15.963030835456548, -97.64099229372569 15.977762092491902, -97.6799802940711 15.96284896808574, -97.79060478285606 15.985764256807403, -97.90788575950488 16.063603491512733, -97.98966546754647 16.115253824821878, -98.08856185866655 16.16999590343474, -98.22581229890692 16.236559361150043, -98.3281954217652 16.258019710905252, -98.43152947146118 16.27384217216545, -98.55261415546076 16.316035402192636, -98.53866722850793 16.347134722600607, -98.45403473995324 16.385690605211657, -98.39951493459218 16.38041645145826, -98.36623249527293 16.42370088571029, -98.34974976341958 16.44497936809469, -98.35704020250856 16.47735176009831, -98.39539425162884 16.546825095746524, -98.31678429971288 16.569922251838992, -98.29301112877056 16.557737137994934, -98.20584283531537 16.585926580469994, -98.19379776203792 16.62139071777733, -98.21408420124203 16.618844574586035, -98.23817434779693 16.70723211679816, -98.13927795667685 16.723600180170777, -98.13579122493864 16.75742751114085, -98.10789737103298 16.76161046066941, -98.07239610242577 16.87345889371562, -98.08095444396501 16.88491653807645, -98.11138410277118 16.958936557994836, -98.09743717581836 16.968939263389213, -98.0578152242478 17.02386320937288, -98.03055532156728 17.01567917768657, -98.02516673615368 17.018952790361094, -98.00773307746265 17.039867538003882, -98.07271307803833 17.064237765692, -98.08127141957758 17.06660204151249, -98.09870507826861 17.08387944173914, -98.18365454243586 17.117706772709212, -98.22264254278127 17.122071589608577, -98.21757093298024 17.186634506245007, -98.20330703041485 17.216097020315715, -98.24229503076026 17.25046995339821, -98.28857347019465 17.238648574295766, -98.3228068363516 17.27465831371552, -98.30505620204801 17.327581718620312, -98.2873055677444 17.32885479021596, -98.30537317766057 17.394327043706426, -98.33580283646674 17.45634381715156, -98.33231610472853 17.47180254367014, -98.31202966552442 17.477440432165153, -98.33168215350341 17.519451794821535, -98.33009727544058 17.533273715002856, -98.37700966610011 17.605111326471558, -98.41251093470731 17.600928376943003, -98.46100820342966 17.63039089101371, -98.47083444741915 17.677858274794296, -98.48985298417301 17.703319706707255, -98.49429064274892 17.77279304235547, -98.47146839864429 17.788615503615667, -98.42487298359733 17.839538367441584, -98.42487298359733 17.86572726883777, -98.38271522712627 17.88355027117684, -98.33516888524161 17.883732138547646, -98.33168215350341 17.879912923760703, -98.29839971418416 17.911012244168674, -98.26258146996437 17.927744042282903, -98.26258146996437 17.927016572799676, -98.24704966494873 17.878639852165055, -98.20711073776562 17.886823883851363, -98.16590390813225 17.91937814322579, -98.15322488362968 17.96775486386041, -98.12976868829992 17.977939436625594, -98.10726341980785 17.98266798826657, -98.05147571199652 17.981940518783343, -98.03055532156728 17.99194322417772, -97.99473707734751 17.97466582395107, -97.96747717466697 17.970482874422512, -97.93482868657284 17.96084390376975, -97.93673054024823 17.925197899091607, -97.9031311253164 17.909193570460605, -97.87935795437409 17.917923204259335, -97.81913258798686 17.914649591584812, -97.81311005134813 17.945203309880362, -97.768099514364 17.976666365029946, -97.77000136803939 17.99721737793112, -97.6986818552124 18.021769472990044, -97.7715862461022 18.068145652545788, -97.79884614878274 18.03577326054217, -97.79092175846863 18.00412833802178, -97.82642302707583 17.972483415501387, -97.84258878331661 18.018859595057133, -97.83688322229045 18.032681515238455, -97.81057424644762 18.067781917804176, -97.86065639323279 18.10251858562828, -97.86382614935843 18.147803560959186, -97.83941902719097 18.17126445179327, -97.85019619801817 18.18854185201992, -97.844490636992 18.216003825011754, -97.79726127071991 18.282931017468673, -97.78363131937965 18.28602276277239, -97.74971492883526 18.275838190007207, -97.66349756221776 18.29184251863821, -97.64384507423877 18.279475537423345, -97.64257717178852 18.187086913053466, -97.65208644016545 18.176902340288283, -97.61531726910798 18.153259582083393, -97.56967278089871 18.103427922482318, -97.56808790283588 18.092152145492292, -97.55762770762126 18.046867170161388, -97.47965170693044 18.027043626743442, -97.46982546294095 18.027043626743442, -97.41118497461653 18.102336718257476, -97.36902721814548 18.100518044549407, -97.3528614619047 18.123251465900264, -97.30911882737082 18.155987592645495, -97.23748233893127 18.17308312550134, -97.21434311921408 18.163626022219383, -97.16774770416711 18.20072696586398, -97.13383131362274 18.157806266353564, -97.0888207766386 18.149076632554834, -97.04222536159163 18.156533194757916, -97.02510867851316 18.189814923615568, -97.00894292227238 18.205637384875764, -96.97692838540338 18.232553755755177, -96.94111014118361 18.21964117242789, -96.93698945822027 18.216003825011754, -96.93635550699514 18.216549427124175, -96.91068048237743 18.23873724636261, -96.9046579457387 18.23764604213777, -96.86630389661842 18.242010859037133, -96.85520975017867 18.241283389553907, -96.82224428647197 18.32057756322569, -96.78452418857682 18.33840056556476, -96.75346057854551 18.392960776806817, -96.72873648076549 18.39568878736892, -96.73349111495396 18.374046570242903, -96.69640496828393 18.364589466960947, -96.6815071144934 18.41223871811234, -96.70623121227342 18.423150760360752, -96.70528028543573 18.456250621847598, -96.6824580413311 18.499716923470434, -96.72715160270268 18.529725039653563, -96.69957472440957 18.553185930487647, -96.70211052931009 18.580829770850286, -96.67928828520546 18.607564274358893, -96.68435989500648 18.644301483261877, -96.68340896816879 18.66939918043322, -96.6282552115826 18.631752634676204))",2023,Total,4276769,4244538,4276769,32231,32231,0.76
18,,11,Guanajuato,"POLYGON ((-101.21711115467667 21.81588656276246, -101.21964695957719 21.80224650995195, -101.16132344686535 21.757507136733466, -101.05925729961963 21.765509301048965, -100.98159827454137 21.75296045246329, -100.91249759100234 21.713677100369015, -100.90235437140028 21.682032177848622, -100.85322315145281 21.67421188090393, -100.83452159031151 21.664572910251167, -100.8576608100287 21.618924200178647, -100.80948051691892 21.592007829299234, -100.75147397981965 21.580550184938403, -100.71755758927526 21.549996466642853, -100.68110539383036 21.547450323451557, -100.6576491985006 21.524535034729894, -100.63577788123366 21.543267373923, -100.61485749080441 21.50580269553679, -100.5847448076108 21.522352626280213, -100.5340287096005 21.542358037068965, -100.46429407483635 21.543085506552192, -100.4557357332971 21.556179957250286, -100.48584841649073 21.594372105119724, -100.45953944064789 21.628381303460603, -100.45129807472121 21.666209716588426, -100.35018285431318 21.69148928113058, -100.27759543903595 21.686578862118793, -100.22339260928744 21.6654822471052, -100.18060090159125 21.650205387957424, -100.16728792586355 21.60146493258119, -100.14700148665943 21.618014863324614, -100.07599894944502 21.557816763587546, -100.06268597371732 21.523261963134246, -99.95745007034596 21.526171841067157, -99.9650574850475 21.505984562907596, -99.94413709461826 21.461427057059918, -99.9064169967231 21.447968871620212, -99.86742899637768 21.47343030353317, -99.81702987397995 21.461608924430728, -99.77772489802197 21.495072520659185, -99.77899280047222 21.394863599344614, -99.79452460548788 21.357398920958403, -99.75775543443041 21.292108534838746, -99.73715201961373 21.312841415110725, -99.67375689710086 21.296837086479723, -99.69879797049344 21.26755643977982, -99.69372636069241 21.23591151725943, -99.73873689767655 21.235547782517816, -99.82939192286996 21.157890415183292, -99.88834938680692 21.169529926914933, -99.90419816743514 21.18517052080432, -99.94794080196903 21.212450626425348, -99.98661182670187 21.218270382291166, -100.0113359244819 21.189535337703685, -99.99643807069137 21.18244251024222, -100.02655075388498 21.073503955128917, -100.01513963183267 21.05095240114887, -100.01165290009446 21.040767828383686, -100.02243007092164 21.01439705961669, -100.0611010956545 21.028400847168818, -100.06078412004193 21.00584929318877, -100.09248168129837 20.931829273270385, -100.1882083162928 20.93255674275361, -100.24589787777951 20.963292328419968, -100.26364851208311 20.970930757993855, -100.2655503657585 20.92928313007909, -100.3340170980724 20.89054538009723, -100.41421192805117 20.887999236905934, -100.45383387962173 20.900184350749992, -100.47253544076302 20.928191925854247, -100.46999963586251 20.907095310840653, -100.50771973375767 20.869448765083636, -100.5020141727315 20.852898834340213, -100.55970373421822 20.82998354561855, -100.56414139279411 20.77451399752246, -100.5492435390036 20.736321849653024, -100.59647290527568 20.717225775718305, -100.58220900271029 20.676851219399186, -100.56223953911874 20.671213330904173, -100.55114539267898 20.633566785147156, -100.5295910510246 20.638659071529748, -100.48901817261637 20.594465300423686, -100.4852144652656 20.55372700936295, -100.50518392885715 20.5550000809586, -100.50803670937023 20.518262872055615, -100.4887011970038 20.473341631466326, -100.4887011970038 20.42569238031493, -100.46999963586251 20.386772762962266, -100.40945729386272 20.375315118601435, -100.40343475722399 20.36058386156608, -100.38663504975808 20.30693298717806, -100.35081680553832 20.288382515355764, -100.32355690285777 20.252009041194395, -100.35525446411421 20.219091047078354, -100.35588841533934 20.182353838175374, -100.38092948873192 20.129794168012193, -100.38980480588373 20.080689977894345, -100.35810724462729 20.064685649263343, -100.36286187881575 19.98993815986173, -100.44844529420813 19.982663465029454, -100.511840416721 19.95811136997053, -100.53593056327588 19.92301096740481, -100.52705524612409 19.96574979954442, -100.5926691979249 19.966477269027646, -100.55780188054283 19.99157496619899, -100.60186149068927 19.98593707770398, -100.61992910060545 19.95702016574569, -100.66050197901367 19.96447672794877, -100.71660666243757 19.941379571856302, -100.74703632124374 19.912826394639627, -100.78000178495044 19.91555440520173, -100.79204685822788 19.955565226779235, -100.82469534632202 19.978298648130092, -100.83578949276176 19.934650479136447, -100.90901085926413 19.96211245212828, -100.94768188399698 19.962476186869896, -100.9590930060493 19.930831264349504, -101.00315261619573 19.95301908358794, -100.97018715248905 20.005215019009505, -101.0142467626355 20.045589575328624, -100.99269242098111 20.064685649263343, -101.01171095773498 20.08159931474838, -101.08049466566145 20.08287238634403, -101.132478666122 20.060684567105593, -101.17400247136793 20.09778551075019, -101.19650773986 20.057047219689455, -101.16068949564023 20.03995168683361, -101.20157934966102 20.025766031910678, -101.20316422772385 20.00721556008838, -101.23834852071849 20.032131389888917, -101.29191739924187 20.03595060467586, -101.32836959468676 20.03194952251811, -101.40254188802682 20.044862105845397, -101.40856442466554 20.122883207921532, -101.38922891229912 20.130339770124614, -101.42251135161837 20.163257764240655, -101.42029252233043 20.2016317794809, -101.36323691206884 20.19563015624427, -101.36133505839345 20.248917295890678, -101.39525144893784 20.248371693778257, -101.41997554671786 20.274378727803636, -101.45864657145071 20.26946830879185, -101.44501662011044 20.28965558695141, -101.45991447390097 20.323482917921485, -101.46023144951353 20.323482917921485, -101.50048735230921 20.311479671448232, -101.52330959641384 20.33239441909102, -101.56388247482208 20.320391172617768, -101.62727759733494 20.303295639761924, -101.62569271927212 20.266922165600555, -101.64788101215163 20.238187121013073, -101.68591808565935 20.218363577595127, -101.69384247597345 20.191810941457327, -101.72744189090528 20.211452617504467, -101.76040735461197 20.201813646851704, -101.7965425744443 20.212725689100115, -101.83489662356459 20.224728935573367, -101.9147744779308 20.194175217277817, -101.90780101445439 20.215089964920605, -101.93981555132339 20.227093211393857, -101.95154364898828 20.2707413803875, -101.93474394152236 20.297475883896105, -101.9601019905275 20.30584178295322, -101.94647203918724 20.343124593968625, -101.99021467372113 20.36058386156608, -102.02539896671577 20.34730754349718, -102.0108180885378 20.379316200759185, -102.09640150393018 20.384044752400165, -102.06406999144862 20.4407873720919, -102.06121721093554 20.44478845424965, -102.00955018608755 20.544997375564222, -101.9841921370824 20.53481280279904, -101.96897730767931 20.56245664316168, -101.95154364898828 20.60683228163855, -101.96802638084162 20.663574901330286, -102.01937643007705 20.67612374991596, -102.01430482027601 20.7170439083475, -102.03459125948014 20.741959738148037, -102.06438696706118 20.738686125473514, -102.06755672318683 20.771604119589554, -102.07389623543811 20.776514538601337, -102.08752618677838 20.778878814421827, -102.0802357476894 20.827983004539675, -102.05487769868425 20.846351608991167, -101.93727974642287 20.95565389884608, -101.90875194129208 20.99839273098569, -101.88688062402514 21.061136973914053, -101.87166579462206 21.095328039625738, -101.81777994048612 21.10678568398657, -101.83362872111434 21.13733940228212, -101.7876672572925 21.15643547621684, -101.77372033033967 21.21972532125762, -101.76864872053865 21.257735601756252, -101.68655203688448 21.29410907591762, -101.64344335357572 21.29938322967102, -101.64597915847624 21.3281182742585, -101.6428094023506 21.354852777767107, -101.6792615977955 21.39322679300735, -101.59684793852877 21.4210525007408, -101.5708559382985 21.418506357549504, -101.58924052382721 21.46470066973444, -101.64090754867522 21.528717984258453, -101.62283993875904 21.544722312889455, -101.58638774331415 21.60783029055943, -101.59367818240312 21.631654916135126, -101.55785993818336 21.734955582753415, -101.58004823106286 21.736228654349063, -101.58575379208901 21.778785619117865, -101.5388414014295 21.777694414893023, -101.51063057191126 21.798791029906617, -101.49636666934586 21.809884939525837, -101.47386140085379 21.827344207123293, -101.42314530284351 21.824979931302803, -101.36608969258192 21.839347453596545, -101.31949427753496 21.835346371438796, -101.29191739924187 21.812794817458744, -101.21711115467667 21.81588656276246))",2023,Total,6422483,6360814,6422483,61669,61669,0.97
19,,1,Aguascalientes,"POLYGON ((-102.25330443214953 22.37458312588109, -102.18895838279897 22.362398012037033, -102.162015455731 22.348394224484906, -102.15345711419177 22.290378533197522, -102.12429535783585 22.286923053152194, -102.07548111350093 22.306019127086913, -102.0374440399932 22.298744432254637, -102.02254618620269 22.24145621045048, -101.99972394209806 22.219450258582853, -102.00099184454831 22.167981792644515, -102.0260329179409 22.129789644775077, -101.96802638084162 22.11123917295278, -101.86437535553307 22.041583969933757, -101.86183955063257 22.028853253977278, -101.86247350185769 21.991388575591067, -101.89765779485234 21.95828871410422, -101.88592969718745 21.932645414820456, -101.83553057478971 21.94155691598999, -101.83806637969023 21.907183982907497, -101.88054111177385 21.91009386084041, -101.94171740499878 21.889360980568426, -102.03871194244347 21.853169373777867, -102.05297584500886 21.813340419571166, -102.06438696706118 21.79624488671532, -102.10495984546942 21.751687380867644, -102.14204599213944 21.7053112013119, -102.17818121197178 21.688215668456056, -102.21463340741668 21.694762893805102, -102.22731243191926 21.656752613306473, -102.29546218862059 21.653115265890335, -102.32589184742677 21.622015945482364, -102.38453233575117 21.651842194294687, -102.41971662874582 21.669301461892143, -102.55506521531079 21.74350334918134, -102.58327604482902 21.74386708392295, -102.63367516722676 21.767327974757034, -102.6910477531009 21.752414850350874, -102.69611936290192 21.728590224775175, -102.74556755846197 21.720042458347255, -102.8536562423464 21.798791029906617, -102.8476337057077 21.83316396298911, -102.86855409613693 21.860625935980945, -102.84351302274435 21.926280056842216, -102.8057929248492 21.996298994602853, -102.74556755846197 22.080503587286422, -102.69390053361398 22.104691947603733, -102.6412825819283 22.22836175975239, -102.67012736267165 22.24563915997904, -102.66917643583396 22.29165160479317, -102.61212082557238 22.291469737422364, -102.52590345895487 22.290924135309943, -102.46219136082944 22.322932792571947, -102.47106667798124 22.336209110640848, -102.46853087308072 22.35166783715943, -102.37850979911245 22.36094307307058, -102.35917428674603 22.384767698646275, -102.32145418885086 22.38858691343322, -102.31194492047393 22.456969044856592, -102.29831496913367 22.459515188047888, -102.29007360320699 22.419868101211996, -102.25330443214953 22.37458312588109))",2023,Total,1510839,1491126,1510839,19713,19713,1.32
20,,22,Querétaro,"POLYGON ((-99.18846723426485 21.669847064004564, -99.17230147802407 21.627108231864955, -99.13077767277814 21.596554513569405, -99.14218879483045 21.53453774012427, -99.12919279471531 21.48670662160207, -99.12253630685146 21.45324302537361, -99.09844616029656 21.40832178478432, -99.09305757488298 21.36340054419503, -99.12950977032787 21.362127472599383, -99.13806811186711 21.329755080595763, -99.10478567254785 21.30047443389586, -99.05502050137525 21.282287696815175, -99.07372206251655 21.23882139519234, -99.05248469647474 21.219543453886814, -99.05406957453756 21.163528303678305, -99.05502050137525 21.159527221520555, -99.17578820976227 21.13843060650696, -99.1808598195633 21.126609227404515, -99.24362099085104 21.103693938682852, -99.30860099142673 21.147160240305688, -99.3364948453324 21.130064707449847, -99.34632108932189 21.10096592812075, -99.3897467482432 21.102420867087204, -99.398622065395 21.088417079535077, -99.36375474801292 21.04858812532838, -99.38435816282961 21.009668507975714, -99.40432762642116 20.928919395337473, -99.45599465126915 20.849443354294884, -99.48262060272455 20.8392587815297, -99.4902280174261 20.796701816760898, -99.54855153013794 20.73723118650706, -99.53048392022177 20.70485879450344, -99.50227309070355 20.659028217060115, -99.57359260353053 20.634839856742804, -99.62430870154083 20.593374096198843, -99.63445192114288 20.6055592100429, -99.73525016593834 20.564820918982168, -99.8281240204197 20.542451232372926, -99.83541445950868 20.480980061040214, -99.83573143512125 20.477888315736497, -99.859187630451 20.26837710456701, -99.91339046019951 20.285836372164468, -99.93431085062876 20.250190367486326, -99.92258275296388 20.231094293551607, -99.91941299683823 20.21709050599948, -99.95111055809467 20.21581743440383, -99.95808402157108 20.25164530645278, -99.97773650955007 20.2389145904963, -99.96600841188518 20.2016317794809, -99.93240899695337 20.17380607174745, -99.9419182653303 20.118882125763783, -99.92638646031465 20.06414004715092, -99.98027231445059 20.05904776076833, -100.00024177804214 20.077416365219822, -100.04398441257602 20.036496206788282, -100.07694987628271 20.029403379326816, -100.13780919389507 20.044316503732976, -100.2015212920205 20.07577955888256, -100.19771758466973 20.129794168012193, -100.23607163379002 20.1432523534519, -100.19201202364357 20.175988480197134, -100.18155182842895 20.205087259526227, -100.26079573157004 20.267467767712976, -100.307391146617 20.285290770052047, -100.35081680553832 20.288382515355764, -100.38663504975808 20.30693298717806, -100.40343475722399 20.36058386156608, -100.40945729386272 20.375315118601435, -100.46999963586251 20.386772762962266, -100.4887011970038 20.42569238031493, -100.4887011970038 20.473341631466326, -100.50803670937023 20.518262872055615, -100.50518392885715 20.5550000809586, -100.4852144652656 20.55372700936295, -100.48901817261637 20.594465300423686, -100.5295910510246 20.638659071529748, -100.55114539267898 20.633566785147156, -100.56223953911874 20.671213330904173, -100.58220900271029 20.676851219399186, -100.59647290527568 20.717225775718305, -100.5492435390036 20.736321849653024, -100.56414139279411 20.77451399752246, -100.55970373421822 20.82998354561855, -100.5020141727315 20.852898834340213, -100.50771973375767 20.869448765083636, -100.46999963586251 20.907095310840653, -100.47253544076302 20.928191925854247, -100.45383387962173 20.900184350749992, -100.41421192805117 20.887999236905934, -100.3340170980724 20.89054538009723, -100.2655503657585 20.92928313007909, -100.26364851208311 20.970930757993855, -100.24589787777951 20.963292328419968, -100.1882083162928 20.93255674275361, -100.09248168129837 20.931829273270385, -100.06078412004193 21.00584929318877, -100.0611010956545 21.028400847168818, -100.02243007092164 21.01439705961669, -100.01165290009446 21.040767828383686, -100.01513963183267 21.05095240114887, -100.02655075388498 21.073503955128917, -99.99643807069137 21.18244251024222, -100.0113359244819 21.189535337703685, -99.98661182670187 21.218270382291166, -99.94794080196903 21.212450626425348, -99.90419816743514 21.18517052080432, -99.88834938680692 21.169529926914933, -99.82939192286996 21.157890415183292, -99.73873689767655 21.235547782517816, -99.69372636069241 21.23591151725943, -99.69879797049344 21.26755643977982, -99.67375689710086 21.296837086479723, -99.73715201961373 21.312841415110725, -99.75775543443041 21.292108534838746, -99.79452460548788 21.357398920958403, -99.77899280047222 21.394863599344614, -99.77772489802197 21.495072520659185, -99.74951406850374 21.523261963134246, -99.74666128799066 21.578185909117913, -99.7054544583573 21.570547479544025, -99.66107787259828 21.56854693846515, -99.62589357960364 21.507257634503244, -99.55013640820077 21.447241402136985, -99.55298918871384 21.428872797685493, -99.50607679805432 21.41868822492031, -99.47184343189737 21.43596562514696, -99.43380635838965 21.44869634110344, -99.41573874847349 21.428872797685493, -99.3719961139396 21.507075767132438, -99.37579982129037 21.547995925563978, -99.30543123530109 21.53290093378701, -99.27436762526978 21.56800133635273, -99.27943923507081 21.608012157930236, -99.23411172247411 21.62874503820222, -99.2182629418459 21.66602784921762, -99.18846723426485 21.669847064004564))",2023,Total,2557915,2508214,2557915,49701,49701,1.98
21,,24,San Luis Potosí,"POLYGON ((-100.60376334436467 24.401313106152582, -100.59995963701388 24.348571568618596, -100.63324207633315 24.225992960694782, -100.58506178322337 24.223992419615907, -100.5936201247626 24.17816184217258, -100.61358958835416 24.173797025273217, -100.5172290021346 24.139787826932338, -100.53878334378896 24.118509344547938, -100.52420246561101 24.071405695508965, -100.54131914868948 24.025756985436445, -100.56287349034386 23.919728308256055, -100.54005124623923 23.888447120477277, -100.55019446584129 23.84207094092153, -100.52864012418691 23.817518845862608, -100.49789348976817 23.798604639298695, -100.49028607506662 23.73967961115728, -100.44559251369505 23.67729910297053, -100.47729007495148 23.633832801347694, -100.49187095312945 23.56836054785723, -100.46999963586251 23.56654187414916, -100.45953944064789 23.511617928165492, -100.49440675802995 23.52834972627972, -100.51754597774716 23.421047977503683, -100.45700363574737 23.366305898890822, -100.48362958720277 23.214082909525494, -100.479825879852 23.194259366107545, -100.33211524439702 23.162432576216347, -100.32355690285777 23.195532437703193, -100.36412978126602 23.188985212354147, -100.37427300086807 23.265369508093023, -100.33211524439702 23.259004150114784, -100.3064402197793 23.26100469119366, -100.27854636587364 23.310108881311507, -100.2202228531618 23.29792376746745, -100.22846421908847 23.250274516316054, -100.10420977896325 23.23154217712295, -100.11815670591608 23.20044285671498, -100.11562090101556 23.12605910205498, -100.06902548596861 23.121148683043195, -100.06965943719374 23.09677845535508, -100.02243007092164 23.060041246452094, -100.06680665668065 23.03148806923542, -100.07409709576963 22.996569534040503, -100.09945514477478 23.00784531103053, -100.08931192517272 22.96856195893625, -100.11118324243967 22.97565478639772, -100.11023231560196 22.9167297582563, -100.04430138818859 22.91782096248114, -100.02940353439806 22.824159266515615, -100.1019909496753 22.762869962553708, -100.02243007092164 22.725950886279918, -99.9571330947334 22.751594185563683, -99.88359475261846 22.74832057288916, -99.84270489859766 22.73049757055009, -99.84809348401126 22.678119767757718, -99.80561875192762 22.65775062222735, -99.78311348343556 22.668480797104955, -99.7241560194986 22.65956929593542, -99.68263221425266 22.681211513061434, -99.56059660341539 22.641200691483927, -99.51368421275586 22.615011790087742, -99.494665676002 22.62083154595356, -99.53935923737357 22.72922449895444, -99.54474782278717 22.743955755989795, -99.47754899292353 22.740682143315272, -99.44236469992889 22.66357037809317, -99.38562606527987 22.670117603442215, -99.37358099200242 22.62901557763987, -99.32983835746855 22.634835333505688, -99.30543123530109 22.58845915394994, -99.2724657715944 22.513166062435907, -99.26327347883003 22.46969976081307, -99.23220986879872 22.412411539008914, -99.11492889214992 22.406773650513905, -99.06104303801398 22.415321416941826, -98.93235093931285 22.392769862961778, -98.91903796358514 22.371491380577375, -98.91047962204591 22.371491380577375, -98.82140947491533 22.356032654058794, -98.75167484015117 22.36894523738608, -98.745969279125 22.38094848385933, -98.67084605894726 22.405682446289063, -98.68194020538701 22.371491380577375, -98.58272683865437 22.373128186914638, -98.57924010691616 22.348394224484906, -98.53549747238229 22.33784591697811, -98.47812488650814 22.29619828906334, -98.44674430086427 22.305655392345297, -98.40522049561834 22.256005600115028, -98.3681343489483 22.2552781306318, -98.37447386119959 22.236000189326276, -98.32597659247725 22.243093016787743, -98.34467815361855 22.222178269144955, -98.33643678769187 22.187623468691655, -98.4321634226863 22.128334705808623, -98.4340652763617 22.05631522696911, -98.49460761836148 21.96065298992471, -98.52218449665457 21.97920346174701, -98.56212342383769 21.96756395001537, -98.5789231313036 21.959925520441484, -98.55324810668588 21.933372884303683, -98.51235825266508 21.949377212934685, -98.49872830132482 21.92737126106706, -98.54342186269639 21.932645414820456, -98.54849347249743 21.859898466497718, -98.51806381369124 21.829526615572973, -98.4882681061102 21.837528779888476, -98.45466869117837 21.76569116841977, -98.51330917950278 21.726225948954685, -98.53296166748177 21.697309036996398, -98.56719503363873 21.717678182526765, -98.55863669209948 21.687670066343635, -98.61949600971184 21.671120135600212, -98.64390313187928 21.631836783505932, -98.62139786338722 21.627835701348182, -98.625201570738 21.591462227186813, -98.60237932663337 21.543449241293807, -98.53264469186921 21.500892276525004, -98.51711288685355 21.46069958757669, -98.52218449665457 21.427599726089845, -98.51077337460227 21.398864681502364, -98.50443386235098 21.389407578220407, -98.51647893562843 21.361218135745347, -98.53930117973306 21.38358782235459, -98.60174537540823 21.35830825781244, -98.64390313187928 21.36631042212794, -98.68352508344984 21.34194019443982, -98.6277373756385 21.31084087403185, -98.59952654612029 21.292108534838746, -98.60935279010978 21.200992982064516, -98.63946547330339 21.183169979725445, -98.68257415661215 21.2006292473229, -98.69113249815138 21.16734751846525, -98.69683805917754 21.161709629970236, -98.71490566909371 21.18335184709625, -98.71966030328217 21.183897449208672, -98.74121464493655 21.188989735591264, -98.76847454761707 21.174440345926715, -98.76910849884221 21.174440345926715, -98.82457923104097 21.16098216048701, -98.84708449953304 21.176259019634784, -98.88258576814025 21.179532632309307, -98.90382313418206 21.212632493796153, -98.93298489053798 21.29811015807537, -98.94281113452747 21.30265684234554, -98.94534693942799 21.31138647614427, -99.05502050137525 21.282287696815175, -99.10478567254785 21.30047443389586, -99.13806811186711 21.329755080595763, -99.12950977032787 21.362127472599383, -99.09305757488298 21.36340054419503, -99.09844616029656 21.40832178478432, -99.12253630685146 21.45324302537361, -99.12919279471531 21.48670662160207, -99.14218879483045 21.53453774012427, -99.13077767277814 21.596554513569405, -99.17230147802407 21.627108231864955, -99.18846723426485 21.669847064004564, -99.2182629418459 21.66602784921762, -99.23411172247411 21.62874503820222, -99.27943923507081 21.608012157930236, -99.27436762526978 21.56800133635273, -99.30543123530109 21.53290093378701, -99.37579982129037 21.547995925563978, -99.3719961139396 21.507075767132438, -99.41573874847349 21.428872797685493, -99.43380635838965 21.44869634110344, -99.47184343189737 21.43596562514696, -99.50607679805432 21.41868822492031, -99.55298918871384 21.428872797685493, -99.55013640820077 21.447241402136985, -99.62589357960364 21.507257634503244, -99.66107787259828 21.56854693846515, -99.7054544583573 21.570547479544025, -99.74666128799066 21.578185909117913, -99.74951406850374 21.523261963134246, -99.77772489802197 21.495072520659185, -99.81702987397995 21.461608924430728, -99.86742899637768 21.47343030353317, -99.9064169967231 21.447968871620212, -99.94413709461826 21.461427057059918, -99.9650574850475 21.505984562907596, -99.95745007034596 21.526171841067157, -100.06268597371732 21.523261963134246, -100.07599894944502 21.557816763587546, -100.14700148665943 21.618014863324614, -100.16728792586355 21.60146493258119, -100.18060090159125 21.650205387957424, -100.22339260928744 21.6654822471052, -100.27759543903595 21.686578862118793, -100.35018285431318 21.69148928113058, -100.45129807472121 21.666209716588426, -100.45953944064789 21.628381303460603, -100.48584841649073 21.594372105119724, -100.4557357332971 21.556179957250286, -100.46429407483635 21.543085506552192, -100.5340287096005 21.542358037068965, -100.5847448076108 21.522352626280213, -100.61485749080441 21.50580269553679, -100.63577788123366 21.543267373923, -100.6576491985006 21.524535034729894, -100.68110539383036 21.547450323451557, -100.71755758927526 21.549996466642853, -100.75147397981965 21.580550184938403, -100.80948051691892 21.592007829299234, -100.8576608100287 21.618924200178647, -100.83452159031151 21.664572910251167, -100.85322315145281 21.67421188090393, -100.90235437140028 21.682032177848622, -100.91249759100234 21.713677100369015, -100.98159827454137 21.75296045246329, -101.05925729961963 21.765509301048965, -101.16132344686535 21.757507136733466, -101.21964695957719 21.80224650995195, -101.21711115467667 21.81588656276246, -101.29191739924187 21.812794817458744, -101.31949427753496 21.835346371438796, -101.36608969258192 21.839347453596545, -101.42314530284351 21.824979931302803, -101.47386140085379 21.827344207123293, -101.49636666934586 21.809884939525837, -101.48305369361816 21.867536896071606, -101.41046627834093 21.908457054503145, -101.43043574193248 21.932281680078844, -101.37401408289603 21.989388034512192, -101.32773564346164 21.99702646408608, -101.35404461930447 22.044675715237474, -101.35087486317883 22.087050812635468, -101.32963749713701 22.13542753327009, -101.3413655948019 22.151977464013513, -101.3511918387914 22.176711426443244, -101.324565887336 22.20962942055928, -101.36989339993269 22.253277589552926, -101.41617183936708 22.267281377105054, -101.39176471719964 22.29983563647948, -101.41997554671786 22.315112495627254, -101.43328852244557 22.36312548152026, -101.3822554488227 22.35730572565444, -101.37464803412115 22.456241575373365, -101.31410569212137 22.453513564811264, -101.28589486260314 22.50789190868251, -101.29350227730468 22.58445807179219, -101.33724491183857 22.658659959081383, -101.38003661953475 22.67575549193723, -101.36608969258192 22.69175982056823, -101.34960696072858 22.711765231356985, -101.41110022956606 22.747593103405933, -101.49129505954484 22.74195521491092, -101.49731759618356 22.7015806585918, -101.56768618217285 22.656841285373318, -101.57402569442414 22.612647514267252, -101.6561223780783 22.513893531919138, -101.69606130526141 22.520440757268183, -101.74614345204657 22.508619378165736, -101.73536628121938 22.48024806831987, -101.77150150105172 22.488068365264564, -101.79812745250713 22.470063495554687, -101.79939535495738 22.470609097667108, -101.83711545285254 22.499526009625395, -101.82031574538664 22.55117634293454, -101.87293369707231 22.562815854666177, -101.85328120909332 22.65593194851928, -101.94615506357468 22.650475927395078, -101.94837389286263 22.651930866361532, -102.12492930906097 22.782693505971654, -102.19212813892462 22.86489755757635, -102.19719974872564 22.88272055991542, -102.23396891978311 23.024940843886373, -102.25996092001338 23.04585559152916, -102.21431643180412 23.13133325580838, -102.24094238325952 23.1691616689362, -102.23967448080927 23.209354357884514, -102.28943965198187 23.231724044493756, -102.28595292024366 23.273189805037717, -102.25488931021235 23.280828234611604, -102.29641311545828 23.32029345407669, -102.2536214077621 23.365032827295174, -102.23808960274644 23.446691276787448, -102.19371301698743 23.447600613641484, -102.19181116331205 23.401406301456543, -102.16898891920742 23.398860158265247, -102.16898891920742 23.361031745137424, -102.12239350416046 23.35375705030515, -102.01240296660063 23.37267125686906, -101.77498823278992 23.447600613641484, -101.46657096176482 23.693667166343147, -101.34073164357677 23.79714970033224, -101.19302100812179 23.918637104031212, -101.20950373997513 24.086864422027546, -101.21679417906411 24.159611370350284, -101.17368549575536 24.164158054620454, -101.06527983625836 24.206896886760063, -101.01297886018523 24.390582931274977, -100.9876208111801 24.43259429393136, -101.01012607967216 24.385126910150774, -101.00663934793394 24.33565898529131, -100.94546305470902 24.281280641420064, -100.85068734655229 24.343297414865198, -100.74228168705528 24.460420001664808, -100.71121807702397 24.49133745470197, -100.60376334436467 24.401313106152582))",2023,Total,2931052,2905759,2931052,25293,25293,0.87
22,,29,Tlaxcala,"POLYGON ((-98.04006458994421 19.699495968683195, -98.04260039484473 19.640025338429357, -97.9937861505098 19.629658898293368, -97.98871454070878 19.629113296180947, -97.9538472233267 19.60419746638041, -97.88284468611229 19.572188809118405, -97.86984868599716 19.54236256030608, -97.8898181495887 19.504170412436643, -97.84861131995534 19.48252819531063, -97.8622412712956 19.456157426543637, -97.79440849020683 19.498350656570825, -97.79694429510735 19.472343622545445, -97.75510351424886 19.45761236551009, -97.73893775800808 19.432696535709553, -97.73576800188243 19.432514668338747, -97.704070440626 19.39304944887366, -97.66444848905546 19.365041873769407, -97.63148302534876 19.355402903116644, -97.64638087913929 19.306480580369602, -97.69107444051086 19.28592956746843, -97.71991922125422 19.304843774032342, -97.77126927048964 19.28356529164794, -97.82071746604967 19.304480039290727, -97.83846810035328 19.287202639064077, -97.86160732007048 19.285383965356008, -97.87048263722228 19.270652708320654, -97.86509405180868 19.253920910206425, -97.85114712485586 19.222821589798453, -97.91517619859385 19.173171797568184, -97.92848917432156 19.16426029639865, -97.97920527233185 19.192631606244518, -97.99188429683443 19.19590521891904, -98.03182322401753 19.231005621484762, -98.04228341923216 19.210090873841974, -98.100606931944 19.163350959544616, -98.11962546869786 19.13534338444036, -98.16622088374481 19.104971533515616, -98.18936010346201 19.13698019077762, -98.22454439645665 19.137889527631657, -98.22454439645665 19.138071395002463, -98.24229503076026 19.157349336307988, -98.26258146996437 19.16080481635332, -98.28793951896952 19.17389926705141, -98.30632410449826 19.188812391457574, -98.31202966552442 19.190449197794834, -98.32375776318929 19.168625113298013, -98.34024049504265 19.185902513524663, -98.33104820227828 19.19990630107679, -98.369085275786 19.226095202472976, -98.3779605929378 19.25464837968965, -98.41060908103194 19.291749323334248, -98.40807327613142 19.31593768365156, -98.4419896666758 19.32739532801239, -98.45530264240351 19.345400197722267, -98.48700020365993 19.389412101457523, -98.48763415488507 19.389957703569944, -98.48763415488507 19.392321979390434, -98.50823756970175 19.426876779843735, -98.54183698463358 19.460704110813808, -98.59128518019361 19.449246466452976, -98.63407688788979 19.467796938275274, -98.65309542464365 19.4657963971964, -98.70856615684242 19.55454767415014, -98.68130625416188 19.598195843143785, -98.6705290833347 19.598559577885396, -98.66545747353366 19.606198007459284, -98.61347347307311 19.601105721076692, -98.57924010691616 19.637842929979676, -98.5503953261728 19.61856498867415, -98.53581444799485 19.63420558256354, -98.51933171614151 19.60237879267234, -98.4917548378484 19.607289211684126, -98.40965815419423 19.616564447595273, -98.38208127590114 19.609289752763, -98.36686644649805 19.628022091956105, -98.32375776318929 19.68531031376026, -98.33168215350341 19.72222939003405, -98.26733610415285 19.720228848955177, -98.26543425047745 19.716955236280654, -98.2552910308754 19.718592042617914, -98.23849132340949 19.6756713431075, -98.15956439588096 19.66930598512926, -98.11487083450939 19.687856456951558, -98.10028995633144 19.67112465883733, -98.06066800476088 19.728776615383097, -98.04006458994421 19.699495968683195))",2023,Total,1412895,1395020,1412895,17875,17875,1.28
23,,21,Puebla,"POLYGON ((-97.75034888006039 20.814706686470775, -97.71357970900293 20.799793562064615, -97.72055317247934 20.776878273342952, -97.72055317247934 20.776696405972146, -97.72055317247934 20.776878273342952, -97.72847756279346 20.741414136035615, -97.7528846849609 20.732320767495274, -97.75193375812322 20.701585181828918, -97.7493979532227 20.64320575579992, -97.70470439185112 20.629565702989407, -97.70121766011292 20.574278022264124, -97.68505190387214 20.573004950668476, -97.65747502557903 20.544997375564222, -97.65050156210262 20.565002786352977, -97.58995922010283 20.55609128518344, -97.54177892699305 20.488436623243295, -97.57601229315 20.49098276643459, -97.60105336654259 20.460792782880652, -97.63401883024927 20.452790618565153, -97.64669785475185 20.40841498008828, -97.67427473304495 20.410961123279577, -97.7094590260396 20.454973027014834, -97.73386614820704 20.451881281711117, -97.74876400199757 20.42169129815718, -97.76556370946348 20.380953007096448, -97.69678000153702 20.319845570505347, -97.67934634284597 20.34967181931767, -97.67712751355802 20.30693298717806, -97.70882507481446 20.285290770052047, -97.75763931914938 20.279289146815422, -97.73640195310756 20.243825009508086, -97.74179053852116 20.19290214568217, -97.65905990364186 20.168713785364858, -97.6356037083121 20.18253570554618, -97.62229073258439 20.17435167385987, -97.6213398057467 20.17216926541019, -97.60485707389336 20.157801743116448, -97.59566478112899 20.096876173896156, -97.58615551275206 20.079416906298697, -97.56079746374691 20.086691601130973, -97.49550048755866 20.136705128102854, -97.50342487787276 20.148708374576106, -97.48725912163198 20.165440172690335, -97.4631689750771 20.18362690977102, -97.46443687752735 20.224183333460946, -97.44541834077349 20.246189285328576, -97.40643034042807 20.232367365147255, -97.37948741336011 20.249644765373905, -97.371563023046 20.219091047078354, -97.31577531523467 20.200540575256056, -97.28693053449132 20.19126533934491, -97.1642609724289 20.151800119879823, -97.14999706986352 20.160347886307743, -97.14048780148659 20.11960959524701, -97.21053941186331 20.041042891058453, -97.20736965573766 20.014308387549846, -97.2612555098736 19.97666184179283, -97.25586692446001 19.932468070686767, -97.3021453638944 19.876634787849063, -97.31545833962211 19.827530597731215, -97.32211482748596 19.735687575473758, -97.33320897392571 19.71677336890985, -97.30404721756979 19.67112465883733, -97.3262355104493 19.678944955782022, -97.3804383401978 19.634023715192733, -97.42006029176834 19.624021009798355, -97.43432419433374 19.588375005120213, -97.42671677963219 19.541635090822854, -97.40484546236524 19.49580451337953, -97.34810682771624 19.484710603760313, -97.35761609609317 19.432150933597132, -97.38963063296217 19.42942292303503, -97.36078585221881 19.375953916017817, -97.33796360811418 19.39250384676124, -97.28185892469028 19.38741156037865, -97.26696107089975 19.382319273996057, -97.21053941186331 19.359403985274394, -97.21561102166433 19.323030511113025, -97.20071316787381 19.309026723560898, -97.14872916741325 19.320302500550923, -97.14777824057556 19.320302500550923, -97.09737911817783 19.304480039290727, -97.04317628842932 19.31884756158447, -97.01528243452367 19.293022394929896, -96.9918262391939 19.285747700097623, -96.98612067816775 19.28010981160261, -97.0016524831834 19.23627977523816, -97.02954633708906 19.218093038157477, -97.05648926415704 19.19772389262711, -97.0381046786283 19.13425218021552, -97.0533195080314 19.132251639136644, -97.0755078009109 19.15789493842041, -97.14429150883736 19.163714694286227, -97.14429150883736 19.164078429027843, -97.19469063123509 19.171898725972536, -97.20134711909894 19.141890609789407, -97.26062155864847 19.098606175537377, -97.26696107089975 19.030224044114004, -97.2675950221249 19.029678442001583, -97.26886292457515 19.02822350303513, -97.28502868081593 18.999488458447647, -97.26157248548617 18.981119853996155, -97.25523297323488 18.943837042980753, -97.24730858292077 18.918739345809406, -97.29834165654363 18.860541787151217, -97.32591853483673 18.812892535999822, -97.3262355104493 18.811619464404174, -97.35349541312982 18.791068451503, -97.33099014463775 18.763788345881974, -97.34905775455393 18.715957227359773, -97.34430312036547 18.685767243805838, -97.30341326634466 18.674309599445007, -97.27393453437618 18.63302570627185, -97.27393453437618 18.632843838901046, -97.23589746086846 18.64339214640784, -97.22670516810409 18.638663594766864, -97.14238965516196 18.59337861943596, -97.14460848444992 18.571008932826718, -97.11259394758092 18.52135914059645, -97.08121336193705 18.46352531667987, -96.99911667828289 18.531907448103247, -96.99626389776981 18.528451968057915, -96.95315521446105 18.553913399970874, -96.92589531178052 18.534817326036155, -96.89958633593768 18.548639246217476, -96.86630389661842 18.52590582486662, -96.8425307256761 18.493351565492194, -96.7972032130794 18.511902037314492, -96.78167140806374 18.42951611833899, -96.72873648076549 18.39568878736892, -96.75346057854551 18.392960776806817, -96.78452418857682 18.33840056556476, -96.82224428647197 18.32057756322569, -96.85520975017867 18.241283389553907, -96.86630389661842 18.242010859037133, -96.9046579457387 18.23764604213777, -96.91068048237743 18.23873724636261, -96.93635550699514 18.216549427124175, -96.93698945822027 18.216003825011754, -96.94111014118361 18.21964117242789, -96.97692838540338 18.232553755755177, -97.00894292227238 18.205637384875764, -97.02510867851316 18.189814923615568, -97.04222536159163 18.156533194757916, -97.0888207766386 18.149076632554834, -97.13383131362274 18.157806266353564, -97.16774770416711 18.20072696586398, -97.21434311921408 18.163626022219383, -97.23748233893127 18.17308312550134, -97.30911882737082 18.155987592645495, -97.3528614619047 18.123251465900264, -97.36902721814548 18.100518044549407, -97.41118497461653 18.102336718257476, -97.46982546294095 18.027043626743442, -97.47965170693044 18.027043626743442, -97.55762770762126 18.046867170161388, -97.56808790283588 18.092152145492292, -97.56967278089871 18.103427922482318, -97.61531726910798 18.153259582083393, -97.65208644016545 18.176902340288283, -97.64257717178852 18.187086913053466, -97.64384507423877 18.279475537423345, -97.66349756221776 18.29184251863821, -97.74971492883526 18.275838190007207, -97.78363131937965 18.28602276277239, -97.79726127071991 18.282931017468673, -97.844490636992 18.216003825011754, -97.85019619801817 18.18854185201992, -97.83941902719097 18.17126445179327, -97.86382614935843 18.147803560959186, -97.86065639323279 18.10251858562828, -97.81057424644762 18.067781917804176, -97.83688322229045 18.032681515238455, -97.84258878331661 18.018859595057133, -97.82642302707583 17.972483415501387, -97.79092175846863 18.00412833802178, -97.79884614878274 18.03577326054217, -97.7715862461022 18.068145652545788, -97.6986818552124 18.021769472990044, -97.77000136803939 17.99721737793112, -97.768099514364 17.976666365029946, -97.81311005134813 17.945203309880362, -97.81913258798686 17.914649591584812, -97.87935795437409 17.917923204259335, -97.9031311253164 17.909193570460605, -97.93673054024823 17.925197899091607, -97.93482868657284 17.96084390376975, -97.96747717466697 17.970482874422512, -97.99473707734751 17.97466582395107, -98.03055532156728 17.99194322417772, -98.05147571199652 17.981940518783343, -98.10726341980785 17.98266798826657, -98.12976868829992 17.977939436625594, -98.15322488362968 17.96775486386041, -98.16590390813225 17.91937814322579, -98.20711073776562 17.886823883851363, -98.24704966494873 17.878639852165055, -98.26258146996437 17.927016572799676, -98.26258146996437 17.927744042282903, -98.29839971418416 17.911012244168674, -98.33168215350341 17.879912923760703, -98.33516888524161 17.883732138547646, -98.38271522712627 17.88355027117684, -98.42487298359733 17.86572726883777, -98.44072176422554 17.92265175590031, -98.42297112992193 17.94174782983503, -98.4340652763617 17.983759192491412, -98.48700020365993 17.99085201995288, -98.5237693747174 17.9941256326274, -98.52979191135613 17.975575160805104, -98.58494566794232 17.973756487097035, -98.64485405871699 17.933381930777916, -98.68796274202573 17.96193510799459, -98.81506996266404 18.007947552808723, -98.7380448888109 18.039956210070727, -98.81285113337609 18.06469017250046, -98.86990674363767 18.05705174292657, -98.86008049964818 18.092152145492292, -98.85944654842305 18.12852561965366, -98.88512157304076 18.166899634893905, -98.95707503709286 18.18854185201992, -99.00050069601419 18.190178658357183, -98.98940654957443 18.2491036864986, -99.02332294011882 18.248376217015373, -99.03188128165806 18.27220084259107, -99.05438655015013 18.252195431802317, -99.066114647815 18.332580809698943, -98.98560284222366 18.41987714768623, -98.93964137840183 18.421877688765104, -98.91523425623437 18.45715995870163, -98.85025425565868 18.47807470634442, -98.84169591411944 18.507173485673516, -98.81094927970071 18.519176732146768, -98.75484459627681 18.456978091330825, -98.72695074237114 18.43951882373337, -98.70666430316703 18.444974844857573, -98.70793220561728 18.4988075866164, -98.71268683980576 18.58519458774965, -98.7193433276696 18.605018131167597, -98.72790166920885 18.66939918043322, -98.74089766932399 18.703772113515715, -98.7158565959314 18.739054383452242, -98.75357669382656 18.74269173086838, -98.74755415718784 18.75815045738696, -98.72790166920885 18.80616344327997, -98.69525318111472 18.844901193261826, -98.69081552253881 18.855449500768625, -98.68891366886344 18.85799564395992, -98.68891366886344 18.858177511330727, -98.68891366886344 18.85799564395992, -98.67211396139751 18.87981972845674, -98.67781952242368 18.924013499562804, -98.64865776606776 19.0009433974141, -98.63280898543954 19.01549278707865, -98.6277373756385 19.0222218797985, -98.62361669267517 19.066415650904567, -98.63914849769083 19.077509560523783, -98.62710342441338 19.124613209562757, -98.63629571717775 19.153348254150238, -98.63914849769083 19.16353282691542, -98.64041640014108 19.16717017433156, -98.64390313187928 19.23864405105865, -98.6277373756385 19.25774012499337, -98.63217503421441 19.263741748229993, -98.66387259547085 19.324849184821094, -98.64485405871699 19.351765555700506, -98.65753308321956 19.39705053103141, -98.66038586373264 19.432150933597132, -98.6350278147275 19.4312415967431, -98.65309542464365 19.4657963971964, -98.63407688788979 19.467796938275274, -98.59128518019361 19.449246466452976, -98.54183698463358 19.460704110813808, -98.50823756970175 19.426876779843735, -98.48763415488507 19.392321979390434, -98.48763415488507 19.389957703569944, -98.48700020365993 19.389412101457523, -98.45530264240351 19.345400197722267, -98.4419896666758 19.32739532801239, -98.40807327613142 19.31593768365156, -98.41060908103194 19.291749323334248, -98.3779605929378 19.25464837968965, -98.369085275786 19.226095202472976, -98.33104820227828 19.19990630107679, -98.34024049504265 19.185902513524663, -98.32375776318929 19.168625113298013, -98.31202966552442 19.190449197794834, -98.30632410449826 19.188812391457574, -98.28793951896952 19.17389926705141, -98.26258146996437 19.16080481635332, -98.24229503076026 19.157349336307988, -98.22454439645665 19.138071395002463, -98.22454439645665 19.137889527631657, -98.18936010346201 19.13698019077762, -98.16622088374481 19.104971533515616, -98.11962546869786 19.13534338444036, -98.100606931944 19.163350959544616, -98.04228341923216 19.210090873841974, -98.03182322401753 19.231005621484762, -97.99188429683443 19.19590521891904, -97.97920527233185 19.192631606244518, -97.92848917432156 19.16426029639865, -97.91517619859385 19.173171797568184, -97.85114712485586 19.222821589798453, -97.86509405180868 19.253920910206425, -97.87048263722228 19.270652708320654, -97.86160732007048 19.285383965356008, -97.83846810035328 19.287202639064077, -97.82071746604967 19.304480039290727, -97.77126927048964 19.28356529164794, -97.71991922125422 19.304843774032342, -97.69107444051086 19.28592956746843, -97.64638087913929 19.306480580369602, -97.63148302534876 19.355402903116644, -97.66444848905546 19.365041873769407, -97.704070440626 19.39304944887366, -97.73576800188243 19.432514668338747, -97.73893775800808 19.432696535709553, -97.75510351424886 19.45761236551009, -97.79694429510735 19.472343622545445, -97.79440849020683 19.498350656570825, -97.8622412712956 19.456157426543637, -97.84861131995534 19.48252819531063, -97.8898181495887 19.504170412436643, -97.86984868599716 19.54236256030608, -97.88284468611229 19.572188809118405, -97.9538472233267 19.60419746638041, -97.98871454070878 19.629113296180947, -97.9937861505098 19.629658898293368, -98.04260039484473 19.640025338429357, -98.04006458994421 19.699495968683195, -98.06066800476088 19.728776615383097, -98.10028995633144 19.67112465883733, -98.11487083450939 19.687856456951558, -98.15956439588096 19.66930598512926, -98.23849132340949 19.6756713431075, -98.2552910308754 19.718592042617914, -98.1956996157133 19.741507331339577, -98.19443171326304 19.765331956915276, -98.23500459167128 19.776971468646913, -98.26733610415285 19.84335305899141, -98.28350186039363 19.84699040640755, -98.3148824460375 19.85426510123982, -98.26987190905336 19.89536712704217, -98.26797005537797 19.91610000731415, -98.21598605491742 19.96847781010652, -98.16685483496994 19.971569555410237, -98.17382829844637 20.03358632885537, -98.18080176192278 20.045407707957818, -98.15797951781815 20.084145457939677, -98.12818381023709 20.107242614032145, -98.09807112704348 20.14379795556432, -98.1361082005512 20.146889700868037, -98.12976868829992 20.17653408230955, -98.14783629821609 20.220727853415617, -98.14688537137839 20.220364118674002, -98.19221288397509 20.25801066443102, -98.2597286894513 20.21527183229141, -98.28445278723132 20.262739216072, -98.25465707965027 20.30129509868305, -98.19062800591227 20.293838536479967, -98.1814357131479 20.33639550124877, -98.12659893217428 20.33694110336119, -98.11296898083401 20.35421850358784, -98.09997298071887 20.382226078692096, -98.09426741969271 20.38659089559146, -98.07112819997552 20.429511595101875, -98.02548371176624 20.448607669036594, -98.01280468726367 20.46679440611728, -97.98871454070878 20.495165715963147, -97.98522780897058 20.516989800459967, -97.98110712600723 20.54045069129405, -97.9094706375677 20.586463136108183, -97.8952067350023 20.623200345011167, -97.91359132053103 20.6719408003874, -97.89742556429024 20.70304012079537, -97.92246663768283 20.716498306235078, -97.8952067350023 20.79761115361493, -97.87935795437409 20.834348362517915, -97.83878507596584 20.83634890359679, -97.82325327095019 20.81034186957141, -97.77285414855245 20.827255535056448, -97.75034888006039 20.814706686470775))",2023,Total,6907421,6824785,6907421,82636,82636,1.21
24,,13,Hidalgo,"POLYGON ((-98.46734771568094 21.378495535971997, -98.46639678884326 21.365219217903096, -98.46924956935634 21.358853859924857, -98.49777737448713 21.327936406887694, -98.54405581392152 21.263919092363686, -98.51679591124099 21.244095548945737, -98.46861561813121 21.24973343744075, -98.48192859385891 21.229546159281192, -98.45308381311555 21.203175390514197, -98.4429405935135 21.178077693342853, -98.42582391043501 21.16734751846525, -98.4242390323722 21.16734751846525, -98.42233717869681 21.163164568936693, -98.36528156843522 21.161709629970236, -98.34087444626778 21.16971179428574, -98.3094938606239 21.184988653433514, -98.29935064102185 21.179532632309307, -98.2961808848962 21.187716663995616, -98.28255093355594 21.136430065428087, -98.24926849423667 21.12915537059581, -98.22739717696973 21.150433852980214, -98.18745824978663 21.110604898773513, -98.15068907872916 21.08496159948975, -98.16178322516892 21.018761876516056, -98.19696751816356 21.016579468066375, -98.21598605491742 20.952562153542363, -98.23722342095922 20.932374875382806, -98.23722342095922 20.930738069045542, -98.22517834768179 20.90654970872823, -98.26543425047745 20.86635701977992, -98.25402312842515 20.82143577919063, -98.22517834768179 20.817980299145297, -98.24800059178642 20.789245254557816, -98.30473922643544 20.78215242709635, -98.29998459224697 20.800157296806226, -98.34372722678086 20.797974888356546, -98.31519942165006 20.809614400088183, -98.35323649515779 20.83580330148437, -98.34499512923111 20.864902080813465, -98.42518995920989 20.84962522166569, -98.44389152035119 20.83416649514711, -98.46449493516786 20.77451399752246, -98.45308381311555 20.748325096126276, -98.53232771625665 20.71340656093136, -98.53232771625665 20.713224693560555, -98.55007835056024 20.68921820061405, -98.52503727716766 20.681579771040163, -98.46005727659197 20.715043367268624, -98.42582391043501 20.748870698238697, -98.42931064217322 20.716498306235078, -98.44959708137735 20.700493977604076, -98.46386098394274 20.667030381375618, -98.49492459397405 20.64429696002476, -98.48066069140864 20.588463677187057, -98.5060187404138 20.596102106760945, -98.52630517961792 20.544269906080995, -98.55800274087436 20.509169503515274, -98.59730771683233 20.495711318075568, -98.5503953261728 20.432603340405592, -98.54912742372255 20.36476681109464, -98.53486352115715 20.34694380875557, -98.4695665449689 20.335122429653122, -98.45878937414172 20.33366749068667, -98.38620195886448 20.402595224222463, -98.36084390985933 20.39968534628955, -98.317418250938 20.428784125618648, -98.27494351885439 20.481343795781825, -98.26384937241464 20.491346501176203, -98.21218234756665 20.5284474448208, -98.17319434722123 20.529720516416447, -98.1227952248235 20.585735666624956, -98.11138410277118 20.6161075175497, -98.10092390755656 20.613925109100016, -98.0774677122268 20.65120792011542, -98.06669054139961 20.67375947409547, -98.03626088259344 20.633021183034735, -98.00836702868777 20.532630394349358, -97.98522780897058 20.516989800459967, -97.98871454070878 20.495165715963147, -98.01280468726367 20.46679440611728, -98.02548371176624 20.448607669036594, -98.07112819997552 20.429511595101875, -98.09426741969271 20.38659089559146, -98.09997298071887 20.382226078692096, -98.11296898083401 20.35421850358784, -98.12659893217428 20.33694110336119, -98.1814357131479 20.33639550124877, -98.19062800591227 20.293838536479967, -98.25465707965027 20.30129509868305, -98.28445278723132 20.262739216072, -98.2597286894513 20.21527183229141, -98.19221288397509 20.25801066443102, -98.14688537137839 20.220364118674002, -98.14783629821609 20.220727853415617, -98.12976868829992 20.17653408230955, -98.1361082005512 20.146889700868037, -98.09807112704348 20.14379795556432, -98.12818381023709 20.107242614032145, -98.15797951781815 20.084145457939677, -98.18080176192278 20.045407707957818, -98.17382829844637 20.03358632885537, -98.16685483496994 19.971569555410237, -98.21598605491742 19.96847781010652, -98.26797005537797 19.91610000731415, -98.26987190905336 19.89536712704217, -98.3148824460375 19.85426510123982, -98.28350186039363 19.84699040640755, -98.26733610415285 19.84335305899141, -98.23500459167128 19.776971468646913, -98.19443171326304 19.765331956915276, -98.1956996157133 19.741507331339577, -98.2552910308754 19.718592042617914, -98.26543425047745 19.716955236280654, -98.26733610415285 19.720228848955177, -98.33168215350341 19.72222939003405, -98.32375776318929 19.68531031376026, -98.36686644649805 19.628022091956105, -98.38208127590114 19.609289752763, -98.40965815419423 19.616564447595273, -98.4917548378484 19.607289211684126, -98.51933171614151 19.60237879267234, -98.53581444799485 19.63420558256354, -98.5503953261728 19.61856498867415, -98.57924010691616 19.637842929979676, -98.61347347307311 19.601105721076692, -98.66545747353366 19.606198007459284, -98.66482352230854 19.660394483959724, -98.6198129853244 19.660940086072145, -98.63280898543954 19.72222939003405, -98.60808488765952 19.724957400596153, -98.59699074121977 19.765695691656887, -98.63978244891595 19.810798799616986, -98.66101981495777 19.83462342519268, -98.6784534736488 19.81407241229151, -98.69810596162779 19.83189541463058, -98.67179698578495 19.853537631756595, -98.7291695716591 19.864995276117426, -98.75484459627681 19.876634787849063, -98.78051962089452 19.883545747939724, -98.79541747468505 19.856265642318697, -98.81475298705148 19.867723286679528, -98.8705406948628 19.895003392300556, -98.91396635378412 19.87699852259068, -98.94566391504056 19.803887839526325, -98.97038801282056 19.808616391167305, -99.02047015960574 19.867723286679528, -98.98940654957443 19.881363339490044, -98.95263737851697 19.906461036661387, -98.99574606182571 19.956838298374883, -98.94502996381543 19.97484316808476, -98.94661484187824 20.02722097087713, -98.96151269566877 20.040861023687647, -98.99130840324982 20.067049925083833, -99.0055723058152 20.05322800490251, -99.01381367174189 19.981208526063, -99.03441708655856 19.971569555410237, -99.0315643060455 20.014853989662267, -99.06769952587783 19.985027740849944, -99.07086928200347 20.017945734965984, -99.11841562388813 20.0290396445852, -99.14250577044301 20.027039103506326, -99.18941816110254 19.99266617042383, -99.21541016133281 19.954474022554393, -99.2182629418459 19.88900176906393, -99.23633055176207 19.87336117517454, -99.27088089353157 19.858629918139187, -99.34346830880881 19.780245081321436, -99.38784489456782 19.77715333601772, -99.37358099200242 19.85153709067772, -99.41510479724835 19.850445886452878, -99.43000265103888 19.870815031983245, -99.4325384559394 19.87517984888261, -99.4360251876776 19.903187423986864, -99.48388850517482 19.90518796506574, -99.47406226118532 19.954292155183587, -99.4449005048294 19.985027740849944, -99.44109679747862 20.013217183325004, -99.48705826130046 20.10506020558246, -99.51907279816946 20.148162772463685, -99.50512587121662 20.160347886307743, -99.51241631030561 20.175079143343098, -99.62969728695441 20.145798496643195, -99.65980997014803 20.18071703183811, -99.69911494610601 20.1725330001518, -99.72098626337295 20.167804448510825, -99.78850206884916 20.222910261865298, -99.84207094737253 20.28183529000672, -99.85950460606357 20.26492162452168, -99.859187630451 20.26837710456701, -99.83573143512125 20.477888315736497, -99.83541445950868 20.480980061040214, -99.8281240204197 20.542451232372926, -99.73525016593834 20.564820918982168, -99.63445192114288 20.6055592100429, -99.62430870154083 20.593374096198843, -99.57359260353053 20.634839856742804, -99.50227309070355 20.659028217060115, -99.53048392022177 20.70485879450344, -99.54855153013794 20.73723118650706, -99.4902280174261 20.796701816760898, -99.48262060272455 20.8392587815297, -99.45599465126915 20.849443354294884, -99.40432762642116 20.928919395337473, -99.38435816282961 21.009668507975714, -99.36375474801292 21.04858812532838, -99.398622065395 21.088417079535077, -99.3897467482432 21.102420867087204, -99.34632108932189 21.10096592812075, -99.3364948453324 21.130064707449847, -99.30860099142673 21.147160240305688, -99.24362099085104 21.103693938682852, -99.1808598195633 21.126609227404515, -99.17578820976227 21.13843060650696, -99.05502050137525 21.159527221520555, -99.05406957453756 21.163528303678305, -99.05248469647474 21.219543453886814, -99.07372206251655 21.23882139519234, -99.05502050137525 21.282287696815175, -98.94534693942799 21.31138647614427, -98.94281113452747 21.30265684234554, -98.93298489053798 21.29811015807537, -98.90382313418206 21.212632493796153, -98.88258576814025 21.179532632309307, -98.84708449953304 21.176259019634784, -98.82457923104097 21.16098216048701, -98.76910849884221 21.174440345926715, -98.76847454761707 21.174440345926715, -98.74121464493655 21.188989735591264, -98.71966030328217 21.183897449208672, -98.71490566909371 21.18335184709625, -98.69683805917754 21.161709629970236, -98.69113249815138 21.16734751846525, -98.68257415661215 21.2006292473229, -98.63946547330339 21.183169979725445, -98.60935279010978 21.200992982064516, -98.59952654612029 21.292108534838746, -98.6277373756385 21.31084087403185, -98.68352508344984 21.34194019443982, -98.64390313187928 21.36631042212794, -98.60174537540823 21.35830825781244, -98.53930117973306 21.38358782235459, -98.51647893562843 21.361218135745347, -98.50443386235098 21.389407578220407, -98.46734771568094 21.378495535971997))",2023,Total,3227801,3190331,3227801,37470,37470,1.17
25,,30,Veracruz,"POLYGON ((-97.97032995518005 22.332935497966325, -98.00075961398623 22.29747136065899, -97.95670000383979 22.293652145872045, -97.93546263779797 22.256369334856643, -97.8952067350023 22.222178269144955, -97.85146410046842 22.2074470121096, -97.83624927106533 22.229998566089648, -97.78458224621734 22.262370958093268, -97.79377453898171 22.25018584424921, -97.78553317305503 22.166163118936446, -97.75922419721219 22.080321719915617, -97.70692322113908 21.97065569531909, -97.61658517155824 21.834618901955565, -97.56428419548511 21.770601587431557, -97.4302035113704 21.648932316361776, -97.35444633996752 21.593280900894882, -97.33035619341263 21.558362365699967, -97.32940526657494 21.520533952572144, -97.37441580355907 21.40086522258124, -97.41023404777884 21.338848449136105, -97.4203772673809 21.23081923087684, -97.39216643786267 21.14825144453053, -97.36490653518214 21.097692315446228, -97.2809079978526 20.9136425361897, -97.22892399739203 20.830711015101777, -97.21814682656485 20.79597434727767, -97.19405668000996 20.73941359495674, -97.18106067989483 20.670667728791752, -97.13161248433478 20.599739454177083, -97.05300253241883 20.51917220890965, -96.98643765378031 20.464611997667596, -96.90941257992718 20.366221750061094, -96.78484116418939 20.243279407395665, -96.7055972610483 20.156892406262415, -96.57880701602255 20.007579294829995, -96.5642261378446 19.971569555410237, -96.52618906433688 19.92482964111288, -96.44726213680835 19.84462613058706, -96.40098369737396 19.724775533225348, -96.40700623401268 19.7049519898074, -96.39591208757292 19.644572022699528, -96.37467472153112 19.608380415908968, -96.37499169714368 19.562186103724027, -96.33029813577211 19.497441319716792, -96.30874379411773 19.461977182409456, -96.32173979423287 19.414146063887255, -96.29511384277747 19.322303041629798, -96.22157550066254 19.265378554567256, -96.18195354909199 19.250283562790287, -96.17371218316532 19.226277069843782, -96.12331306076759 19.194632147323393, -96.11855842657913 19.17171685860173, -96.09288340196142 19.15152958044217, -96.09890593860014 19.102243522953515, -96.0618197919301 19.06514257930892, -95.97084779112414 19.052048128610824, -95.96038759590951 18.964569923252732, -95.94105208354308 18.9052811603697, -95.8627591072397 18.832534212046962, -95.74104047201499 18.786703634603636, -95.66433237377441 18.741964261385153, -95.52549705547122 18.714684155764125, -95.43706085956578 18.71086494097718, -95.2874483704354 18.715229757876546, -95.27159958980718 18.707409460931853, -95.18189549145147 18.706863858819432, -95.12230407628937 18.65266738231899, -95.07951236859319 18.64175534007058, -95.04971666101214 18.599562110043394, -95.02530953884468 18.568644657006228, -94.94860144060411 18.549912317813124, -94.89915324504408 18.548639246217476, -94.81642261016478 18.5386365408231, -94.78947968309681 18.507719087785937, -94.77394787808116 18.44915779438613, -94.73305802406036 18.389505296761484, -94.68234192605006 18.349858209925593, -94.65571597459466 18.310029255718895, -94.6233844621131 18.287113966997232, -94.62465236456335 18.25492344236442, -94.59739246188282 18.193452271031706, -94.55967236398766 18.16890017597278, -94.4658475826686 18.150895306262903, -94.35490611827109 18.16380788959019, -94.24016094652279 18.187814382536693, -94.13048738457553 18.21273021233723, -94.13017040896297 18.198726424785104, -94.12034416497346 18.16489909381503, -94.10164260383218 18.172537523388918, -94.10132562821961 18.12852561965366, -94.07438270115163 18.059052284005446, -94.08389196952857 18.00649261384227, -94.0613867010365 17.987032805165935, -94.09023148177985 17.96830046597283, -94.083574993916 17.86972835099552, -94.03729655448161 17.87081955522036, -94.02651938365442 17.840629571666426, -93.9786560661572 17.851723481285642, -93.95836962695309 17.82062416087767, -93.94917733418872 17.768973827568527, -93.92223440712075 17.74642227358848, -93.86961645543506 17.74005691561024, -93.88102757748739 17.725871260687306, -93.8052704060845 17.689134051784322, -93.77230494237781 17.692407664458845, -93.74694689337267 17.66858303888315, -93.73173206396957 17.62529860463112, -93.64900142909028 17.555279666870483, -93.62174152640975 17.5450950941053, -93.62427733131027 17.49326289342535, -93.65312211205362 17.41942474087777, -93.69527986852468 17.387416083615765, -93.63568845336258 17.338311893497917, -93.64139401438874 17.31794274796755, -93.60811157506947 17.314851002663833, -93.66453323410593 17.28611595807635, -93.66294835604312 17.256107841893222, -93.77262191799038 17.245741401757233, -93.80400250363425 17.224826654114445, -93.82714172335145 17.172448851322073, -93.8613750895084 17.163719217523344, -93.86771460175969 17.13680284664393, -94.08737870126677 17.149351695229605, -94.74351821927497 17.18463396516613, -94.82371304925375 17.18863504732388, -94.9229264159864 17.193545466335667, -94.9096134402587 17.26792922099567, -94.8909118791174 17.31103178787689, -94.972691587159 17.331400933407256, -95.0766595880801 17.372866693951217, -95.12230407628937 17.431973589463443, -95.2047177355561 17.53872973612706, -95.25321500427845 17.601292111684614, -95.2785730532836 17.615114031865936, -95.25384895550359 17.6407573311497, -95.18728407686507 17.654761118701828, -95.19045383299071 17.691862062346424, -95.23895110171306 17.739329446127012, -95.26494310194333 17.717869096371803, -95.29600671197464 17.722233913271168, -95.33404378548236 17.675130264232195, -95.35116046856083 17.67822200953591, -95.40631422514703 17.64366720908261, -95.42628368873858 17.64675895438633, -95.477633737974 17.587833926244908, -95.48460720145043 17.601837713797035, -95.52993471404713 17.570738393389064, -95.57272642174331 17.54855057415063, -95.59871842197359 17.534546786598504, -95.64563081263312 17.54691376781337, -95.7026864228947 17.518724325338308, -95.74484417936576 17.585833385166033, -95.80348466769016 17.606930000179627, -95.77337198449655 17.623843665664666, -95.8031676920776 17.629117819418063, -95.89540759533382 17.704410910932097, -95.89128691237049 17.766791419118846, -95.86719676581559 17.773156777097086, -95.84912915589942 17.82753512096833, -95.85927237550149 17.84444878645337, -95.8484952046743 17.8479042664987, -95.79999793595195 17.949749994150533, -95.82440505811941 18.080876368502267, -95.83359735088378 18.129071221766083, -95.8519819364125 18.130526160732536, -95.9026980344228 18.135618447115128, -95.91854681505102 18.151440908375324, -95.9588027178467 18.152895847341778, -95.97940613266337 18.14653048936354, -95.98257588878901 18.1454392851387, -95.9908172547157 18.15125904100452, -96.0164922793334 18.136527783969164, -96.0209299379093 18.137800855564812, -96.06657442611856 18.13161736495738, -96.08400808480961 18.161625481140508, -96.12204515831733 18.14307500931821, -96.17973471980405 18.140528866126914, -96.17149335387737 18.18635944357024, -96.21777179331177 18.161807348511314, -96.28877433052618 18.2623800045675, -96.27324252551053 18.30057215243694, -96.2947968671649 18.312211664168576, -96.30177033064132 18.318031420034394, -96.31983794055749 18.3580422416119, -96.32015491617005 18.3580422416119, -96.35248642865162 18.410238177033467, -96.40288555104934 18.439700691104175, -96.42031920974038 18.507900955156742, -96.45708838079784 18.57028146334349, -96.50843843003327 18.589559404649016, -96.56105638171896 18.587740730940947, -96.58419560143615 18.601744518493074, -96.58419560143615 18.60210825323469, -96.6282552115826 18.631752634676204, -96.68340896816879 18.66939918043322, -96.68435989500648 18.644301483261877, -96.67928828520546 18.607564274358893, -96.70211052931009 18.580829770850286, -96.69957472440957 18.553185930487647, -96.72715160270268 18.529725039653563, -96.6824580413311 18.499716923470434, -96.70528028543573 18.456250621847598, -96.70623121227342 18.423150760360752, -96.6815071144934 18.41223871811234, -96.69640496828393 18.364589466960947, -96.73349111495396 18.374046570242903, -96.72873648076549 18.39568878736892, -96.78167140806374 18.42951611833899, -96.7972032130794 18.511902037314492, -96.8425307256761 18.493351565492194, -96.86630389661842 18.52590582486662, -96.89958633593768 18.548639246217476, -96.92589531178052 18.534817326036155, -96.95315521446105 18.553913399970874, -96.99626389776981 18.528451968057915, -96.99911667828289 18.531907448103247, -97.08121336193705 18.46352531667987, -97.11259394758092 18.52135914059645, -97.14460848444992 18.571008932826718, -97.14238965516196 18.59337861943596, -97.22670516810409 18.638663594766864, -97.23589746086846 18.64339214640784, -97.27393453437618 18.632843838901046, -97.27393453437618 18.63302570627185, -97.30341326634466 18.674309599445007, -97.34430312036547 18.685767243805838, -97.34905775455393 18.715957227359773, -97.33099014463775 18.763788345881974, -97.35349541312982 18.791068451503, -97.3262355104493 18.811619464404174, -97.32591853483673 18.812892535999822, -97.29834165654363 18.860541787151217, -97.24730858292077 18.918739345809406, -97.25523297323488 18.943837042980753, -97.26157248548617 18.981119853996155, -97.28502868081593 18.999488458447647, -97.26886292457515 19.02822350303513, -97.2675950221249 19.029678442001583, -97.26696107089975 19.030224044114004, -97.26062155864847 19.098606175537377, -97.20134711909894 19.141890609789407, -97.19469063123509 19.171898725972536, -97.14429150883736 19.164078429027843, -97.14429150883736 19.163714694286227, -97.0755078009109 19.15789493842041, -97.0533195080314 19.132251639136644, -97.0381046786283 19.13425218021552, -97.05648926415704 19.19772389262711, -97.02954633708906 19.218093038157477, -97.0016524831834 19.23627977523816, -96.98612067816775 19.28010981160261, -96.9918262391939 19.285747700097623, -97.01528243452367 19.293022394929896, -97.04317628842932 19.31884756158447, -97.09737911817783 19.304480039290727, -97.14777824057556 19.320302500550923, -97.14872916741325 19.320302500550923, -97.20071316787381 19.309026723560898, -97.21561102166433 19.323030511113025, -97.21053941186331 19.359403985274394, -97.26696107089975 19.382319273996057, -97.28185892469028 19.38741156037865, -97.33796360811418 19.39250384676124, -97.36078585221881 19.375953916017817, -97.38963063296217 19.42942292303503, -97.35761609609317 19.432150933597132, -97.34810682771624 19.484710603760313, -97.40484546236524 19.49580451337953, -97.42671677963219 19.541635090822854, -97.43432419433374 19.588375005120213, -97.42006029176834 19.624021009798355, -97.3804383401978 19.634023715192733, -97.3262355104493 19.678944955782022, -97.30404721756979 19.67112465883733, -97.33320897392571 19.71677336890985, -97.32211482748596 19.735687575473758, -97.31545833962211 19.827530597731215, -97.3021453638944 19.876634787849063, -97.25586692446001 19.932468070686767, -97.2612555098736 19.97666184179283, -97.20736965573766 20.014308387549846, -97.21053941186331 20.041042891058453, -97.14048780148659 20.11960959524701, -97.14999706986352 20.160347886307743, -97.1642609724289 20.151800119879823, -97.28693053449132 20.19126533934491, -97.31577531523467 20.200540575256056, -97.371563023046 20.219091047078354, -97.37948741336011 20.249644765373905, -97.40643034042807 20.232367365147255, -97.44541834077349 20.246189285328576, -97.46443687752735 20.224183333460946, -97.4631689750771 20.18362690977102, -97.48725912163198 20.165440172690335, -97.50342487787276 20.148708374576106, -97.49550048755866 20.136705128102854, -97.56079746374691 20.086691601130973, -97.58615551275206 20.079416906298697, -97.59566478112899 20.096876173896156, -97.60485707389336 20.157801743116448, -97.6213398057467 20.17216926541019, -97.62229073258439 20.17435167385987, -97.6356037083121 20.18253570554618, -97.65905990364186 20.168713785364858, -97.74179053852116 20.19290214568217, -97.73640195310756 20.243825009508086, -97.75763931914938 20.279289146815422, -97.70882507481446 20.285290770052047, -97.67712751355802 20.30693298717806, -97.67934634284597 20.34967181931767, -97.69678000153702 20.319845570505347, -97.76556370946348 20.380953007096448, -97.74876400199757 20.42169129815718, -97.73386614820704 20.451881281711117, -97.7094590260396 20.454973027014834, -97.67427473304495 20.410961123279577, -97.64669785475185 20.40841498008828, -97.63401883024927 20.452790618565153, -97.60105336654259 20.460792782880652, -97.57601229315 20.49098276643459, -97.54177892699305 20.488436623243295, -97.58995922010283 20.55609128518344, -97.65050156210262 20.565002786352977, -97.65747502557903 20.544997375564222, -97.68505190387214 20.573004950668476, -97.70121766011292 20.574278022264124, -97.70470439185112 20.629565702989407, -97.7493979532227 20.64320575579992, -97.75193375812322 20.701585181828918, -97.7528846849609 20.732320767495274, -97.72847756279346 20.741414136035615, -97.72055317247934 20.776878273342952, -97.72055317247934 20.776696405972146, -97.72055317247934 20.776878273342952, -97.71357970900293 20.799793562064615, -97.75034888006039 20.814706686470775, -97.77285414855245 20.827255535056448, -97.82325327095019 20.81034186957141, -97.83878507596584 20.83634890359679, -97.87935795437409 20.834348362517915, -97.8952067350023 20.79761115361493, -97.92246663768283 20.716498306235078, -97.89742556429024 20.70304012079537, -97.91359132053103 20.6719408003874, -97.8952067350023 20.623200345011167, -97.9094706375677 20.586463136108183, -97.98110712600723 20.54045069129405, -97.98522780897058 20.516989800459967, -98.00836702868777 20.532630394349358, -98.03626088259344 20.633021183034735, -98.06669054139961 20.67375947409547, -98.0774677122268 20.65120792011542, -98.10092390755656 20.613925109100016, -98.11138410277118 20.6161075175497, -98.1227952248235 20.585735666624956, -98.17319434722123 20.529720516416447, -98.21218234756665 20.5284474448208, -98.26384937241464 20.491346501176203, -98.27494351885439 20.481343795781825, -98.317418250938 20.428784125618648, -98.36084390985933 20.39968534628955, -98.38620195886448 20.402595224222463, -98.45878937414172 20.33366749068667, -98.4695665449689 20.335122429653122, -98.53486352115715 20.34694380875557, -98.54912742372255 20.36476681109464, -98.5503953261728 20.432603340405592, -98.59730771683233 20.495711318075568, -98.55800274087436 20.509169503515274, -98.52630517961792 20.544269906080995, -98.5060187404138 20.596102106760945, -98.48066069140864 20.588463677187057, -98.49492459397405 20.64429696002476, -98.46386098394274 20.667030381375618, -98.44959708137735 20.700493977604076, -98.42931064217322 20.716498306235078, -98.42582391043501 20.748870698238697, -98.46005727659197 20.715043367268624, -98.52503727716766 20.681579771040163, -98.55007835056024 20.68921820061405, -98.53232771625665 20.713224693560555, -98.53232771625665 20.71340656093136, -98.45308381311555 20.748325096126276, -98.46449493516786 20.77451399752246, -98.44389152035119 20.83416649514711, -98.42518995920989 20.84962522166569, -98.34499512923111 20.864902080813465, -98.35323649515779 20.83580330148437, -98.31519942165006 20.809614400088183, -98.34372722678086 20.797974888356546, -98.29998459224697 20.800157296806226, -98.30473922643544 20.78215242709635, -98.24800059178642 20.789245254557816, -98.22517834768179 20.817980299145297, -98.25402312842515 20.82143577919063, -98.26543425047745 20.86635701977992, -98.22517834768179 20.90654970872823, -98.23722342095922 20.930738069045542, -98.23722342095922 20.932374875382806, -98.21598605491742 20.952562153542363, -98.19696751816356 21.016579468066375, -98.16178322516892 21.018761876516056, -98.15068907872916 21.08496159948975, -98.18745824978663 21.110604898773513, -98.22739717696973 21.150433852980214, -98.24926849423667 21.12915537059581, -98.28255093355594 21.136430065428087, -98.2961808848962 21.187716663995616, -98.29935064102185 21.179532632309307, -98.3094938606239 21.184988653433514, -98.34087444626778 21.16971179428574, -98.36528156843522 21.161709629970236, -98.42233717869681 21.163164568936693, -98.4242390323722 21.16734751846525, -98.42582391043501 21.16734751846525, -98.4429405935135 21.178077693342853, -98.45308381311555 21.203175390514197, -98.48192859385891 21.229546159281192, -98.46861561813121 21.24973343744075, -98.51679591124099 21.244095548945737, -98.54405581392152 21.263919092363686, -98.49777737448713 21.327936406887694, -98.46924956935634 21.358853859924857, -98.46639678884326 21.365219217903096, -98.46734771568094 21.378495535971997, -98.50443386235098 21.389407578220407, -98.51077337460227 21.398864681502364, -98.52218449665457 21.427599726089845, -98.51711288685355 21.46069958757669, -98.53264469186921 21.500892276525004, -98.60237932663337 21.543449241293807, -98.625201570738 21.591462227186813, -98.62139786338722 21.627835701348182, -98.64390313187928 21.631836783505932, -98.61949600971184 21.671120135600212, -98.55863669209948 21.687670066343635, -98.56719503363873 21.717678182526765, -98.53296166748177 21.697309036996398, -98.51330917950278 21.726225948954685, -98.45466869117837 21.76569116841977, -98.4882681061102 21.837528779888476, -98.51806381369124 21.829526615572973, -98.54849347249743 21.859898466497718, -98.54342186269639 21.932645414820456, -98.49872830132482 21.92737126106706, -98.51235825266508 21.949377212934685, -98.55324810668588 21.933372884303683, -98.5789231313036 21.959925520441484, -98.56212342383769 21.96756395001537, -98.52218449665457 21.97920346174701, -98.49460761836148 21.96065298992471, -98.4340652763617 22.05631522696911, -98.4321634226863 22.128334705808623, -98.33643678769187 22.187623468691655, -98.34467815361855 22.222178269144955, -98.32597659247725 22.243093016787743, -98.37447386119959 22.236000189326276, -98.3681343489483 22.2552781306318, -98.40522049561834 22.256005600115028, -98.44674430086427 22.305655392345297, -98.47812488650814 22.29619828906334, -98.53549747238229 22.33784591697811, -98.57924010691616 22.348394224484906, -98.58272683865437 22.373128186914638, -98.68194020538701 22.371491380577375, -98.67084605894726 22.405682446289063, -98.61379044868568 22.408956058963586, -98.59001727774336 22.394406669299038, -98.54595766759691 22.40004455779405, -98.49080391101072 22.427506530785884, -98.46100820342966 22.41222967163811, -98.4429405935135 22.43241694979767, -98.40965815419423 22.399862690423245, -98.35418742199548 22.389314382916446, -98.31266361674955 22.414230212716983, -98.3193201046134 22.4651530765429, -98.29206020193287 22.467699219734197, -98.19284683520023 22.4651530765429, -98.1858733717238 22.422596111774098, -98.11645571257222 22.396952812490333, -98.10662946858272 22.366762828936398, -98.05844917547294 22.347121152889258, -98.02833649227932 22.358396929879284, -97.97032995518005 22.332935497966325))",2023,Total,8131584,8133233,8131584,-1649,1649,-0.02
26,,19,Nuevo León,"POLYGON ((-99.84333884982279 27.76986054823698, -99.81354314224174 27.774225365136346, -99.79357367865019 27.73294147196319, -99.77328723944606 27.733305206704806, -99.72827670246193 27.679108730204366, -99.92638646031465 27.54907356007747, -99.91941299683823 27.491603470902508, -99.76029123933093 27.437043259660452, -99.74919709289118 27.28900321982368, -99.67914548251446 27.10222543000505, -99.6503007017711 27.06585195584368, -99.73429923910065 26.920539926569013, -99.77043445893298 26.928360223513707, -99.76663075158221 26.889804340902653, -99.74729523921579 26.91017348643302, -99.67914548251446 26.895624096768472, -99.6271614820539 26.87052639959713, -99.58975835977131 26.861069296315172, -99.5808830426195 26.829060639053168, -99.622723823478 26.770499345653363, -99.6182861649021 26.72685117665972, -99.65727416524751 26.69520625413933, -99.65949299453547 26.67029042433879, -99.53840831053589 26.66465253584378, -99.39703718733219 26.59663413916202, -99.4005239190704 26.54989422486466, -99.41605572408605 26.438227659189256, -99.43127055348913 26.351113188572775, -99.41003318744733 26.31692212286109, -99.36375474801292 26.32910723670515, -99.33364206481932 26.306191947983486, -99.26010372270439 26.252722940966272, -99.1976595270292 26.258542696832095, -99.16691289261047 26.075402254429598, -99.16057338035918 26.061216599506665, -99.0955933797835 26.08049454081219, -99.09305757488298 26.0701281006762, -99.02395689134394 26.10413729901708, -98.90097035366898 25.968282373024365, -98.84613357269535 26.024297523232875, -98.82362830420328 26.047394679325343, -98.73677698636064 26.036846371818548, -98.58526264355488 26.017932165254635, -98.58145893620411 25.706029624320895, -98.58177591181668 25.489425585689943, -98.43374830074913 25.489425585689943, -98.42360508114707 25.44741422303356, -98.86388420699895 25.127145783042703, -98.93425279298823 25.072767439171457, -98.9478827443285 25.074040510767105, -99.02268898889369 25.073494908654684, -99.01825133031778 25.08695309409439, -99.03600196462139 25.120052955581237, -99.07340508690399 25.108231576478794, -99.08228040405578 25.073676776025493, -99.16691289261047 25.04657853777527, -99.1799088927256 25.005294644602117, -99.15898850229635 24.916543367648377, -99.20526694173076 24.864165564856005, -99.18244469762612 24.775778022643877, -99.2128743564323 24.77159507311532, -99.29497104008647 24.803967465118937, -99.36597357730088 24.77050386889048, -99.40496157764629 24.734857864212337, -99.45092304146813 24.731038649425393, -99.5000542614156 24.678842714003828, -99.49973728580304 24.64119616824681, -99.57264167669284 24.620099553233217, -99.60972782336286 24.622463829053707, -99.70482050713217 24.575905782127155, -99.73334831226296 24.553899830259525, -99.72003533653526 24.483517157757277, -99.63667075043084 24.506614313849745, -99.61765221367698 24.464057349080946, -99.59007533538387 24.39622081976999, -99.59451299395977 24.330748566279524, -99.64966675054598 24.206896886760063, -99.65695718963495 24.117781875064708, -99.57105679863001 24.03939703824696, -99.54189504227409 24.033395415010332, -99.54126109104897 23.997203808219773, -99.48705826130046 23.96046659931679, -99.45726255371942 23.866077433868035, -99.46772274893404 23.869532913913364, -99.49371474916431 23.87862628245371, -99.57676235965617 23.775507483206226, -99.61955406735235 23.75968502194603, -99.65980997014803 23.77059706419444, -99.80561875192762 23.784237117004956, -99.8610894841264 23.774416278981384, -99.8832777770059 23.723493415155467, -99.91592626510003 23.664932121755662, -99.96125377769673 23.556902903496397, -99.94794080196903 23.497250405871753, -99.92163182612619 23.3790366148473, -99.9828081193511 23.3923129329162, -100.08011963240835 23.395586545590724, -100.1454166085966 23.339571395382215, -100.0779008031204 23.30592593178295, -100.10420977896325 23.23154217712295, -100.22846421908847 23.250274516316054, -100.2202228531618 23.29792376746745, -100.27854636587364 23.310108881311507, -100.3064402197793 23.26100469119366, -100.33211524439702 23.259004150114784, -100.37427300086807 23.265369508093023, -100.36412978126602 23.188985212354147, -100.32355690285777 23.195532437703193, -100.33211524439702 23.162432576216347, -100.479825879852 23.194259366107545, -100.48362958720277 23.214082909525494, -100.45700363574737 23.366305898890822, -100.51754597774716 23.421047977503683, -100.49440675802995 23.52834972627972, -100.45953944064789 23.511617928165492, -100.46999963586251 23.56654187414916, -100.49187095312945 23.56836054785723, -100.47729007495148 23.633832801347694, -100.44559251369505 23.67729910297053, -100.49028607506662 23.73967961115728, -100.49789348976817 23.798604639298695, -100.52864012418691 23.817518845862608, -100.55019446584129 23.84207094092153, -100.54005124623923 23.888447120477277, -100.56287349034386 23.919728308256055, -100.54131914868948 24.025756985436445, -100.52420246561101 24.071405695508965, -100.53878334378896 24.118509344547938, -100.5172290021346 24.139787826932338, -100.61358958835416 24.173797025273217, -100.5936201247626 24.17816184217258, -100.58506178322337 24.223992419615907, -100.63324207633315 24.225992960694782, -100.59995963701388 24.348571568618596, -100.60376334436467 24.401313106152582, -100.71121807702397 24.49133745470197, -100.74228168705528 24.460420001664808, -100.799971248542 24.556264106080015, -100.80567680956815 24.596093060286712, -100.79711846802891 24.75086219284334, -100.82628022438483 24.83506678552691, -100.72738383326475 24.91854390872725, -100.82184256580894 24.996565010803387, -100.80472588273045 25.153152817068083, -100.80314100466764 25.16533793091214, -100.7093162233486 25.23626620552681, -100.59203524669978 25.254998544719918, -100.44400763563223 25.22317175482872, -100.33211524439702 25.18625267855493, -100.32577573214573 25.222080550603877, -100.26174665840773 25.206803691456102, -100.22973212153873 25.21789760107532, -100.26238060963286 25.253907340495076, -100.24367904849156 25.269729801755272, -100.25445621931875 25.306830745399868, -100.32545875653317 25.34029434162833, -100.41484587927631 25.32683615618862, -100.46999963586251 25.337748198437033, -100.45161505033377 25.41049514675977, -100.52261758754818 25.434319772335467, -100.53085895347486 25.463236684293754, -100.58506178322337 25.470875113867642, -100.5793562221972 25.494336004701726, -100.60851797855312 25.513432078636445, -100.5295910510246 25.51415954811967, -100.53878334378896 25.531800683087937, -100.59647290527568 25.544531399044416, -100.63324207633315 25.571265902553023, -100.6906146622073 25.567082953024464, -100.72991963816527 25.633828278110578, -100.7812696874007 25.638556829751554, -100.80599378518072 25.72421636140158, -100.86178149299204 25.818423659479524, -100.82279349264662 25.91681390708603, -100.83483856592407 25.94500334956109, -100.90552412752592 25.956824728663534, -100.91661827396567 26.075402254429598, -100.94324422542108 26.08685989879043, -100.97620968912777 26.132690476233755, -101.04752920195475 26.16979141987835, -101.07510608024785 26.198890199207447, -101.10426783660377 26.261270707394196, -101.20665095946205 26.369845527765882, -100.98413407944187 26.545529407965297, -100.75337583349503 26.735035208346027, -100.69632022323346 26.623368642670627, -100.69124861343242 26.61372967201786, -100.61454051519185 26.685567283486566, -100.607884027328 26.71066498065791, -100.59013339302439 26.759587303404953, -100.53814939256384 26.808509626151995, -100.55146236829154 26.858705020494682, -100.54068519746436 26.880892839733118, -100.54512285604025 26.97982868945204, -100.54005124623923 27.047301484021382, -100.65352851553726 27.075490926496443, -100.69758812568371 27.10859078798329, -100.72516500397681 27.077855202316933, -100.74862119930657 27.081310682362265, -100.79965427292943 27.04584654505493, -100.8310348585733 27.073854120159183, -100.83452159031151 27.19515965648735, -100.67793563770472 27.334833797267006, -100.42277026959042 27.392485753812778, -100.42181934275273 27.392667621183584, -100.41801563540196 27.393576958037617, -100.35081680553832 27.684564751328573, -100.28615378057518 27.730940930884316, -100.18852529190536 27.799141194936883, -99.99929085120445 27.615091415680354, -99.93272597256593 27.67438017856339, -99.84333884982279 27.76986054823698))",2023,Total,6202153,6095498,6202153,106655,106655,1.75
27,,5,Coahuila,"POLYGON ((-100.87953212729565 29.281542134383486, -100.79489963874096 29.24371372125566, -100.76542090677248 29.188062305788765, -100.77651505321224 29.17278544664099, -100.70963319896116 29.11913457225297, -100.68427514995601 29.11113240793747, -100.66462266197702 29.074758933776103, -100.6478229545111 28.940722681491454, -100.60217846630184 28.90234866625121, -100.57174880749567 28.826146237883144, -100.54765866094077 28.82632810525395, -100.53307778276282 28.758127841201382, -100.50803670937023 28.741214175716344, -100.49662558731791 28.658646389370038, -100.44654344053275 28.641732723885, -100.44749436737044 28.6099059339938, -100.40026500109835 28.586626910530526, -100.40914031825015 28.556255059605782, -100.38885387904604 28.515334901174242, -100.33560197613522 28.500603644138888, -100.36793348861679 28.479507029125294, -100.33591895174779 28.43003910426583, -100.34954890308805 28.40184966179077, -100.28615378057518 28.31127971112896, -100.29090841476365 28.2750881043384, -100.2566750486067 28.23926023228945, -100.21927192632411 28.230348731119914, -100.21071358478487 28.19215658325048, -100.09057982762297 28.14814467951522, -100.05602948585347 28.09049272296945, -100.01672450989548 28.061939545752775, -99.99041553405264 27.993557414329402, -99.93367689940362 27.981917902597765, -99.93906548481722 27.94972737796495, -99.89373797222052 27.899350116251455, -99.90134538692206 27.864431581056543, -99.88169289894307 27.849700324021185, -99.8778891915923 27.801323603386564, -99.84333884982279 27.76986054823698, -99.93272597256593 27.67438017856339, -99.99929085120445 27.615091415680354, -100.18852529190536 27.799141194936883, -100.28615378057518 27.730940930884316, -100.35081680553832 27.684564751328573, -100.41801563540196 27.393576958037617, -100.42181934275273 27.392667621183584, -100.42277026959042 27.392485753812778, -100.67793563770472 27.334833797267006, -100.83452159031151 27.19515965648735, -100.8310348585733 27.073854120159183, -100.79965427292943 27.04584654505493, -100.74862119930657 27.081310682362265, -100.72516500397681 27.077855202316933, -100.69758812568371 27.10859078798329, -100.65352851553726 27.075490926496443, -100.54005124623923 27.047301484021382, -100.54512285604025 26.97982868945204, -100.54068519746436 26.880892839733118, -100.55146236829154 26.858705020494682, -100.53814939256384 26.808509626151995, -100.59013339302439 26.759587303404953, -100.607884027328 26.71066498065791, -100.61454051519185 26.685567283486566, -100.69124861343242 26.61372967201786, -100.69632022323346 26.623368642670627, -100.75337583349503 26.735035208346027, -100.98413407944187 26.545529407965297, -101.20665095946205 26.369845527765882, -101.10426783660377 26.261270707394196, -101.07510608024785 26.198890199207447, -101.04752920195475 26.16979141987835, -100.97620968912777 26.132690476233755, -100.94324422542108 26.08685989879043, -100.91661827396567 26.075402254429598, -100.90552412752592 25.956824728663534, -100.83483856592407 25.94500334956109, -100.82279349264662 25.91681390708603, -100.86178149299204 25.818423659479524, -100.80599378518072 25.72421636140158, -100.7812696874007 25.638556829751554, -100.72991963816527 25.633828278110578, -100.6906146622073 25.567082953024464, -100.63324207633315 25.571265902553023, -100.59647290527568 25.544531399044416, -100.53878334378896 25.531800683087937, -100.5295910510246 25.51415954811967, -100.60851797855312 25.513432078636445, -100.5793562221972 25.494336004701726, -100.58506178322337 25.470875113867642, -100.53085895347486 25.463236684293754, -100.52261758754818 25.434319772335467, -100.45161505033377 25.41049514675977, -100.46999963586251 25.337748198437033, -100.41484587927631 25.32683615618862, -100.32545875653317 25.34029434162833, -100.25445621931875 25.306830745399868, -100.24367904849156 25.269729801755272, -100.26238060963286 25.253907340495076, -100.22973212153873 25.21789760107532, -100.26174665840773 25.206803691456102, -100.32577573214573 25.222080550603877, -100.33211524439702 25.18625267855493, -100.44400763563223 25.22317175482872, -100.59203524669978 25.254998544719918, -100.7093162233486 25.23626620552681, -100.80314100466764 25.16533793091214, -100.80472588273045 25.153152817068083, -100.82184256580894 24.996565010803387, -100.72738383326475 24.91854390872725, -100.82628022438483 24.83506678552691, -100.79711846802891 24.75086219284334, -100.80567680956815 24.596093060286712, -100.799971248542 24.556264106080015, -100.84783456603921 24.555536636596788, -100.90235437140028 24.583907946442658, -100.9590930060493 24.542442185898693, -101.08081164127401 24.59118264127493, -101.12772403193352 24.623191298536934, -101.164493202991 24.681388857195124, -101.20157934966102 24.765411582507888, -101.34231652163959 24.813242701030088, -101.40222491241425 24.788145003858745, -101.44882032746122 24.746133641202363, -101.46181632757636 24.736676537920406, -101.59779886536646 24.753953938147056, -101.60033467026697 24.754135805517862, -101.62252296314648 24.759046224529648, -101.64122452428778 24.800693852444418, -101.60920998741878 24.7895999428252, -101.60128559710466 24.83561238763933, -101.65675632930343 24.860710084810677, -101.68560111004679 24.839977204538695, -101.77340335472711 24.875623209216837, -101.83204384305151 24.972012915744465, -101.84916052612999 25.017661625816984, -102.08182062575221 25.070766898092582, -102.23777262713388 25.118416149243977, -102.29546218862059 25.12514524196383, -102.46377623889227 25.11587000605268, -102.45394999490277 25.048215344112535, -102.44665955581378 24.999474888736298, -102.66981038705909 25.066402081193218, -102.85302229112128 24.771776940486127, -102.85619204724692 24.740859487448965, -102.88376892554002 24.75104406021415, -102.923073901498 24.78032470691405, -102.98900482891139 24.796147168174244, -103.09709351279584 24.82651901909899, -103.25906805081621 24.964374486170577, -103.24638902631364 24.99529193920774, -103.2742828802193 25.020753371120698, -103.26223780694185 25.058581784248524, -103.35828141754885 25.10877717859121, -103.3988542959571 25.17624997316055, -103.43403858895174 25.199892731365445, -103.50567507739127 25.276640761845933, -103.49394697972639 25.311559297040844, -103.46288336969509 25.37521287682324, -103.40709566188376 25.398673767657325, -103.33704405150704 25.371393662036297, -103.34148171008295 25.410131412018156, -103.36937556398861 25.416496769996396, -103.47556239419767 25.517978762906615, -103.49331302850126 25.538347908436982, -103.45464200376841 25.557989584484123, -103.42484629618737 25.623643705345394, -103.383639466554 25.639829901347202, -103.35542863703577 25.69129836728554, -103.33926288079499 25.72548943299723, -103.32278014894165 25.82515275219938, -103.34687029549654 25.87698495287933, -103.35067400284731 26.142329446886517, -103.26128688010417 26.28454973085747, -103.31675761230292 26.361843363450383, -103.37413019817707 26.60227202765703, -103.41597097903556 26.616821417321578, -103.63690298099291 26.692478243577227, -103.6584573226473 26.71939461445664, -103.6993471766681 26.72521437032246, -103.75418395764173 26.82942437379478, -103.77985898225944 26.836153466514634, -103.85181244631154 26.896169698880893, -103.8521294219241 26.934725581491946, -103.7846136164479 26.980738026306078, -103.780175957872 27.00892746878114, -103.74499166487736 27.02274938896246, -103.75545186009198 27.081674417103876, -103.78334571399765 27.091131520385833, -103.79951147023843 27.1247769839851, -103.7988775190133 27.21352826093884, -103.81979790944254 27.24299077500955, -103.83215995833255 27.29827845573483, -103.87685351970413 27.311372906432922, -103.85466522682462 27.54961916218989, -103.86037078785078 27.571261379315906, -103.88351000756798 27.600723893386615, -103.89713995890824 27.656557176224318, -103.8816081538926 27.739124962570624, -103.9358109836411 27.797322521228814, -103.90126064187159 27.826603167928717, -103.95990113019599 27.835332801727446, -103.94215049589238 27.927539558726515, -103.89301927594491 27.914081373286812, -103.87812142215438 27.957547674909648, -103.9269356664893 27.971369595090966, -103.8673442513272 28.112134940095466, -103.76813088459456 28.30036766888055, -103.7294598598617 28.35456414538099, -103.64292551763164 28.512425023241335, -103.64260854201908 28.54479741524495, -103.63753693221804 28.554436385897716, -103.59664707819725 28.63955031543532, -103.55734210223926 28.61117900558945, -103.51455039454308 28.665011747348277, -103.40994844239684 28.84069562754769, -103.40360893014555 28.869248804764364, -103.35764746632373 28.92017166859028, -103.30693136831343 29.004012526532236, -103.28030541685803 28.975823084057176, -103.2280044407849 28.991645545317372, -103.15288122060716 28.97200386927023, -103.11674600077482 28.984007115743484, -103.10153117137173 29.057845268291064, -103.08029380532992 29.08676218024935, -103.03972092692169 29.09676488564373, -102.99851409728832 29.174785987719865, -102.9176853160844 29.190972183721676, -102.86760316929924 29.223708310466908, -102.87108990103745 29.240440108581137, -102.90247048668132 29.253898294020843, -102.87742941328874 29.354652817447835, -102.83907536416845 29.358653899605585, -102.82607936405331 29.40230206859923, -102.83083399824177 29.444313431255612, -102.80072131504816 29.48596105917038, -102.8092796565874 29.52124332910691, -102.74017897304837 29.59780949221659, -102.73764316814786 29.641639528581038, -102.69326658238884 29.67673993114676, -102.6910477531009 29.722570508590085, -102.622581020787 29.73602869402979, -102.56362355685003 29.768037351291795, -102.54840872744694 29.744576460457715, -102.51576023935282 29.78458728203522, -102.43429750692378 29.77694885246133, -102.38706814065169 29.76203572805517, -102.3905548723899 29.782768608327153, -102.3398387743796 29.869701211572824, -102.30116774964675 29.877703375888323, -102.26344765175159 29.854242485054243, -102.19910160240103 29.836601350085978, -102.18737350473614 29.848968331300846, -102.14394784581484 29.80350148859913, -102.04853818643296 29.78567848626006, -101.98133935656932 29.815504735072384, -101.9566152587893 29.795499324283632, -101.88339389228693 29.793316915833948, -101.84884355051743 29.80659323390285, -101.81144042823483 29.784223547293607, -101.77372033033967 29.788952098934583, -101.70905730537655 29.761671993313556, -101.66151096349189 29.77131096396632, -101.5743426700367 29.769310422887443, -101.54613184051847 29.811867387656246, -101.53979232826718 29.761308258571944, -101.50207223037202 29.764036269134046, -101.4595974982884 29.78967956841781, -101.45135613236172 29.753306094256445, -101.39873818067605 29.767673616550184, -101.41617183936708 29.746213266794975, -101.37401408289603 29.702201363059718, -101.35658042420499 29.648186753930084, -101.30332852129418 29.652733438200258, -101.31252081405854 29.60981273868984, -101.29698900904289 29.572166192932823, -101.28018930157698 29.618724239859375, -101.25292939889644 29.626362669433263, -101.24310315490695 29.567619508662652, -101.25578217940952 29.520879594365294, -101.1831947641323 29.51706037957835, -101.15213115410099 29.47795889485488, -101.06211008013271 29.464318842044364, -101.05703847033168 29.440676083839474, -101.004420518646 29.365019257583825, -100.95053466451006 29.34810559209879, -100.8861886151595 29.307549168408862, -100.87953212729565 29.281542134383486))",2023,Total,3316738,3273658,3316738,43080,43080,1.32
28,,28,Tamaulipas,"POLYGON ((-99.49656752967739 27.27136208485542, -99.44204772431632 27.250811071954242, -99.4261989436881 27.1778822562607, -99.44014587064093 27.15114775275209, -99.42905172420119 27.091677122498254, -99.45282489514351 27.06239647579835, -99.4449005048294 27.019293908917128, -99.41573874847349 27.017293367838253, -99.3764337725155 26.976918811519134, -99.37833562619089 26.93381624463791, -99.3212800159293 26.906536139016886, -99.32920440624342 26.87961976813747, -99.26802811301849 26.842700691863683, -99.24267006401335 26.787231143767592, -99.23981728350027 26.745037913740404, -99.20875367346896 26.72448690083923, -99.19987835631716 26.655741034674243, -99.17864099027535 26.62082249947933, -99.1675468438356 26.55971506288823, -99.16786381944816 26.536981641537373, -99.12792489226506 26.525342129805736, -99.09147269682015 26.47605607231708, -99.11366098969965 26.434772179143927, -99.09654430662118 26.41203875779307, -99.08164645283065 26.39658003127449, -99.03980567197216 26.413129962017912, -99.01317972051676 26.39294268385835, -98.97799542752212 26.40058111343224, -98.9478827443285 26.37057299724911, -98.92759630512438 26.394397622824805, -98.89780059754334 26.353477464393265, -98.80365884061172 26.36711751720378, -98.77639893793119 26.325288021918205, -98.68003835171163 26.24835812406691, -98.66545747353366 26.235263673368816, -98.58557961916745 26.25763335997806, -98.56497620435077 26.227079641682508, -98.52345239910484 26.220532416333462, -98.50316595990073 26.20852916986021, -98.46259308149249 26.22580657008686, -98.38430010518908 26.156878836551066, -98.33485190962905 26.16524473560818, -98.33516888524161 26.137419027874735, -98.2499024454618 26.072128641755075, -98.19221288397509 26.053214435191165, -98.17953385947251 26.07412918283395, -98.1557606885302 26.056124313124073, -98.07619980977654 26.067581957484904, -98.07112819997552 26.037028239189354, -98.0330911264678 26.062489671102313, -97.97952224794442 26.066490753260062, -97.96620927221672 26.051395761483093, -97.90851971073 26.057579252090527, -97.90249717409128 26.060852864765053, -97.86065639323279 26.052486965707935, -97.80169892929581 26.060125395281823, -97.77792575835349 26.02920794224466, -97.7075571723642 26.03775570867258, -97.63718858637492 26.020296441075125, -97.63275092779902 25.987924049071506, -97.58298575662641 25.93809238947043, -97.54685053679408 25.9346369094251, -97.52117551217637 25.885896454048865, -97.45746341405093 25.884259647711602, -97.45270877986246 25.853524062045246, -97.37251394988368 25.84006587660554, -97.35793307170573 25.889170066723388, -97.37441580355907 25.90571999746681, -97.34810682771624 25.93118142937977, -97.27678731488925 25.935546246279134, -97.28946633939182 25.954460452843044, -97.24635765608308 25.947913227494, -97.20927150941304 25.963735688754195, -97.14651033812531 25.95482418758466, -97.15158194792633 25.824789017457764, -97.1750381432561 25.70402908324202, -97.20229804593663 25.629827195952828, -97.32908829096237 25.41686050473801, -97.44636926761117 25.204257548264806, -97.51768878043816 25.0420318535051, -97.56460117109768 24.912360418119817, -97.65398829384083 24.60173094878173, -97.6809312209088 24.47860673874549, -97.70375346501343 24.34256994538197, -97.72499083105524 24.126693376234243, -97.73766985555781 23.953555639226128, -97.736084977495 23.796785965590626, -97.74242448974628 23.6685694691718, -97.76905044120168 23.37794541062246, -97.76936741681425 23.272098600812875, -97.76112605088758 23.00202555516471, -97.76588068507604 22.894541939017863, -97.78838595356811 22.792878078736837, -97.84132088086636 22.671936277150287, -97.86002244200766 22.54881206711405, -97.85812058833227 22.476428853532926, -97.81976653921198 22.32566080313405, -97.78458224621734 22.262370958093268, -97.83624927106533 22.229998566089648, -97.85146410046842 22.2074470121096, -97.8952067350023 22.222178269144955, -97.93546263779797 22.256369334856643, -97.95670000383979 22.293652145872045, -98.00075961398623 22.29747136065899, -97.97032995518005 22.332935497966325, -98.02833649227932 22.358396929879284, -98.05844917547294 22.347121152889258, -98.10662946858272 22.366762828936398, -98.11645571257222 22.396952812490333, -98.1858733717238 22.422596111774098, -98.19284683520023 22.4651530765429, -98.29206020193287 22.467699219734197, -98.3193201046134 22.4651530765429, -98.31266361674955 22.414230212716983, -98.35418742199548 22.389314382916446, -98.40965815419423 22.399862690423245, -98.4429405935135 22.43241694979767, -98.46100820342966 22.41222967163811, -98.49080391101072 22.427506530785884, -98.54595766759691 22.40004455779405, -98.59001727774336 22.394406669299038, -98.61379044868568 22.408956058963586, -98.67084605894726 22.405682446289063, -98.745969279125 22.38094848385933, -98.75167484015117 22.36894523738608, -98.82140947491533 22.356032654058794, -98.91047962204591 22.371491380577375, -98.91903796358514 22.371491380577375, -98.93235093931285 22.392769862961778, -99.06104303801398 22.415321416941826, -99.11492889214992 22.406773650513905, -99.23220986879872 22.412411539008914, -99.26327347883003 22.46969976081307, -99.2724657715944 22.513166062435907, -99.30543123530109 22.58845915394994, -99.32983835746855 22.634835333505688, -99.37358099200242 22.62901557763987, -99.38562606527987 22.670117603442215, -99.44236469992889 22.66357037809317, -99.47754899292353 22.740682143315272, -99.54474782278717 22.743955755989795, -99.53935923737357 22.72922449895444, -99.494665676002 22.62083154595356, -99.51368421275586 22.615011790087742, -99.56059660341539 22.641200691483927, -99.68263221425266 22.681211513061434, -99.7241560194986 22.65956929593542, -99.78311348343556 22.668480797104955, -99.80561875192762 22.65775062222735, -99.84809348401126 22.678119767757718, -99.84270489859766 22.73049757055009, -99.88359475261846 22.74832057288916, -99.9571330947334 22.751594185563683, -100.02243007092164 22.725950886279918, -100.1019909496753 22.762869962553708, -100.02940353439806 22.824159266515615, -100.04430138818859 22.91782096248114, -100.11023231560196 22.9167297582563, -100.11118324243967 22.97565478639772, -100.08931192517272 22.96856195893625, -100.09945514477478 23.00784531103053, -100.07409709576963 22.996569534040503, -100.06680665668065 23.03148806923542, -100.02243007092164 23.060041246452094, -100.06965943719374 23.09677845535508, -100.06902548596861 23.121148683043195, -100.11562090101556 23.12605910205498, -100.11815670591608 23.20044285671498, -100.10420977896325 23.23154217712295, -100.0779008031204 23.30592593178295, -100.1454166085966 23.339571395382215, -100.08011963240835 23.395586545590724, -99.9828081193511 23.3923129329162, -99.92163182612619 23.3790366148473, -99.94794080196903 23.497250405871753, -99.96125377769673 23.556902903496397, -99.91592626510003 23.664932121755662, -99.8832777770059 23.723493415155467, -99.8610894841264 23.774416278981384, -99.80561875192762 23.784237117004956, -99.65980997014803 23.77059706419444, -99.61955406735235 23.75968502194603, -99.57676235965617 23.775507483206226, -99.49371474916431 23.87862628245371, -99.46772274893404 23.869532913913364, -99.45726255371942 23.866077433868035, -99.48705826130046 23.96046659931679, -99.54126109104897 23.997203808219773, -99.54189504227409 24.033395415010332, -99.57105679863001 24.03939703824696, -99.65695718963495 24.117781875064708, -99.64966675054598 24.206896886760063, -99.59451299395977 24.330748566279524, -99.59007533538387 24.39622081976999, -99.61765221367698 24.464057349080946, -99.63667075043084 24.506614313849745, -99.72003533653526 24.483517157757277, -99.73334831226296 24.553899830259525, -99.70482050713217 24.575905782127155, -99.60972782336286 24.622463829053707, -99.57264167669284 24.620099553233217, -99.49973728580304 24.64119616824681, -99.5000542614156 24.678842714003828, -99.45092304146813 24.731038649425393, -99.40496157764629 24.734857864212337, -99.36597357730088 24.77050386889048, -99.29497104008647 24.803967465118937, -99.2128743564323 24.77159507311532, -99.18244469762612 24.775778022643877, -99.20526694173076 24.864165564856005, -99.15898850229635 24.916543367648377, -99.1799088927256 25.005294644602117, -99.16691289261047 25.04657853777527, -99.08228040405578 25.073676776025493, -99.07340508690399 25.108231576478794, -99.03600196462139 25.120052955581237, -99.01825133031778 25.08695309409439, -99.02268898889369 25.073494908654684, -98.9478827443285 25.074040510767105, -98.93425279298823 25.072767439171457, -98.86388420699895 25.127145783042703, -98.42360508114707 25.44741422303356, -98.43374830074913 25.489425585689943, -98.58177591181668 25.489425585689943, -98.58145893620411 25.706029624320895, -98.58526264355488 26.017932165254635, -98.73677698636064 26.036846371818548, -98.82362830420328 26.047394679325343, -98.84613357269535 26.024297523232875, -98.90097035366898 25.968282373024365, -99.02395689134394 26.10413729901708, -99.09305757488298 26.0701281006762, -99.0955933797835 26.08049454081219, -99.16057338035918 26.061216599506665, -99.16691289261047 26.075402254429598, -99.1976595270292 26.258542696832095, -99.26010372270439 26.252722940966272, -99.33364206481932 26.306191947983486, -99.36375474801292 26.32910723670515, -99.41003318744733 26.31692212286109, -99.43127055348913 26.351113188572775, -99.41605572408605 26.438227659189256, -99.4005239190704 26.54989422486466, -99.39703718733219 26.59663413916202, -99.53840831053589 26.66465253584378, -99.65949299453547 26.67029042433879, -99.65727416524751 26.69520625413933, -99.6182861649021 26.72685117665972, -99.622723823478 26.770499345653363, -99.5808830426195 26.829060639053168, -99.58975835977131 26.861069296315172, -99.6271614820539 26.87052639959713, -99.67914548251446 26.895624096768472, -99.74729523921579 26.91017348643302, -99.76663075158221 26.889804340902653, -99.77043445893298 26.928360223513707, -99.73429923910065 26.920539926569013, -99.6503007017711 27.06585195584368, -99.67914548251446 27.10222543000505, -99.74919709289118 27.28900321982368, -99.76029123933093 27.437043259660452, -99.91941299683823 27.491603470902508, -99.92638646031465 27.54907356007747, -99.72827670246193 27.679108730204366, -99.7108430437709 27.657648380449157, -99.66297972627368 27.656557176224318, -99.63762167726853 27.626549060041185, -99.59990157937337 27.64146218444735, -99.55552499361436 27.614545813567936, -99.51146538346791 27.566169092933315, -99.52858206654639 27.498150696251553, -99.47913387098635 27.479054622316834, -99.49625055406483 27.439407535480942, -99.48769221252559 27.41303676671395, -99.50417494437893 27.339380481537177, -99.53840831053589 27.315919590703096, -99.494665676002 27.303734476859034, -99.49656752967739 27.27136208485542))",2023,Total,3685588,3652671,3685588,32917,32917,0.9
29,,31,Yucatán,"MULTIPOLYGON (((-87.86197767050297 21.571638683768867, -87.73835718160286 21.530172923224907, -87.53517581394912 21.4901621016474, -87.53327396027373 20.999665802581337, -87.57828449725787 20.92564578266295, -87.74437971824159 20.653754063306717, -87.93836879313096 20.47024988616261, -87.96277591529842 20.44660712795772, -87.99510742777998 20.447334597440946, -87.9932055741046 20.423873706606862, -88.06484206254414 20.349489951946865, -88.13679552659625 20.281107820523488, -88.23252216159068 20.290019321693023, -88.26485367407224 20.29038305643464, -88.30891328421869 20.25346398016085, -88.4093945534016 20.252009041194395, -88.52001904218655 20.192174676198942, -88.50258538349551 20.18999226774926, -88.50765699329654 20.1432523534519, -88.57675767683557 20.148162772463685, -88.62113426259458 20.131612841720262, -88.69055192174616 20.08960147906388, -88.70037816573567 20.010307305392097, -88.78342577622752 20.007943029571607, -88.83319094740013 19.878271594186327, -88.88042031367222 19.87790785944471, -88.90038977726377 19.861176061330482, -88.91148392370351 19.800977961593418, -88.9454003142479 19.791702725682267, -88.95681143630023 19.816618555482805, -89.02527816861412 19.776789601276107, -89.04873436394388 19.721501920550825, -88.99516548542051 19.727321676416643, -88.99738431470846 19.7049519898074, -89.03098372964028 19.708771204594346, -89.0360553394413 19.67803561892799, -89.07409241294903 19.694221814929797, -89.12385758412164 19.70331518347014, -89.13368382811113 19.614382039145593, -89.10832577910598 19.612381498066718, -89.10895973033111 19.58237338188359, -89.14953260873935 19.581282177658746, -89.14509495016344 19.63747919523806, -89.22307095085428 19.63656985838403, -89.21990119472864 19.608016681167353, -89.29660929296921 19.55109219410481, -89.41262236716776 19.649300574340508, -89.44812363577496 19.698222897087547, -89.46872705059165 19.700223438166425, -89.49186627030885 19.742052933451998, -89.47601748968063 19.771151712781094, -89.52578266085322 19.77551652968046, -89.58790988091584 19.874452379399383, -89.58695895407814 19.920464824213514, -89.60470958838175 19.938287826552585, -89.59868705174303 19.99794032417723, -89.74861651648597 20.179080225500847, -89.79394402908267 20.136159525990433, -89.80250237062191 20.2016317794809, -89.84370920025528 20.209270209054786, -89.8408564197422 20.250917836969553, -89.87604071273684 20.252918378048427, -89.87255398099863 20.287473178501727, -89.83800363922911 20.287109443760116, -89.90234968857968 20.36476681109464, -90.00409886021284 20.486799816906032, -90.04847544597185 20.45988344602662, -90.06749398272571 20.424964910831704, -90.12930422717575 20.44024176997948, -90.1866768130499 20.436968157304957, -90.1857258862122 20.461156517622268, -90.23454013054712 20.47024988616261, -90.22376295971992 20.51917220890965, -90.23454013054712 20.545361110305837, -90.33533837534257 20.541178160777278, -90.38700540019056 20.55554568307102, -90.38193379038954 20.74705202453063, -90.38193379038954 20.749598167721924, -90.37939798548902 20.848352150070042, -90.40443905888161 20.846533476361973, -90.36323222924824 20.96711154320691, -90.32392725329026 21.019853080740898, -90.19967281316504 21.092600029063636, -90.09475388540623 21.155526139362806, -89.98634822590923 21.180260101792534, -89.92897564003508 21.21572423909987, -89.86462959068452 21.242640609979283, -89.66493495476898 21.288289320051803, -89.6665198328318 21.303202444457963, -89.6665198328318 21.30502111816603, -89.6665198328318 21.303202444457963, -89.63957690576383 21.290471728501483, -89.4877455873455 21.31775183412251, -89.45351222118856 21.32229851839268, -89.32291826881205 21.33848471439449, -89.22624070697992 21.348123685047256, -89.15840792589115 21.355034645137913, -89.06838685192287 21.367583493723586, -88.97139231447818 21.38176914864652, -88.85537924027963 21.396318538311068, -88.79737270318036 21.419597561774346, -88.73746431240569 21.431055206135177, -88.69467260470951 21.45106061692393, -88.60179875022816 21.52580810632554, -88.50036655420756 21.542358037068965, -88.3754781628572 21.567637601611118, -88.31747162575793 21.55072393612608, -88.24329933241788 21.562727182599332, -88.18909650266937 21.604556677884908, -88.13204089240779 21.62510769078608, -88.07340040408339 21.61419564853767, -87.96277591529842 21.61001269900911, -87.86197767050297 21.571638683768867)), ((-89.72991495534467 22.60955576896354, -89.67127446702027 22.594642644557375, -89.58410617356508 22.505345765491214, -89.59107963704149 22.421686774920065, -89.63609017402563 22.373128186914638, -89.7394242237216 22.444056461529307, -89.70804363807773 22.438964175146715, -89.7616125166011 22.480429935690676, -89.76985388252778 22.511165521357032, -89.73815632127135 22.505163898120408, -89.71755290645466 22.536990688011606, -89.75939368731315 22.59955306356916, -89.72991495534467 22.60955576896354)))",2023,Total,2452378,2420401,2452378,31977,31977,1.32
30,,4,Campeche,"POLYGON ((-90.38193379038954 20.749598167721924, -90.38193379038954 20.74705202453063, -90.38700540019056 20.55554568307102, -90.33533837534257 20.541178160777278, -90.23454013054712 20.545361110305837, -90.22376295971992 20.51917220890965, -90.23454013054712 20.47024988616261, -90.1857258862122 20.461156517622268, -90.1866768130499 20.436968157304957, -90.12930422717575 20.44024176997948, -90.06749398272571 20.424964910831704, -90.04847544597185 20.45988344602662, -90.00409886021284 20.486799816906032, -89.90234968857968 20.36476681109464, -89.83800363922911 20.287109443760116, -89.87255398099863 20.287473178501727, -89.87604071273684 20.252918378048427, -89.8408564197422 20.250917836969553, -89.84370920025528 20.209270209054786, -89.80250237062191 20.2016317794809, -89.79394402908267 20.136159525990433, -89.74861651648597 20.179080225500847, -89.59868705174303 19.99794032417723, -89.60470958838175 19.938287826552585, -89.58695895407814 19.920464824213514, -89.58790988091584 19.874452379399383, -89.52578266085322 19.77551652968046, -89.47601748968063 19.771151712781094, -89.49186627030885 19.742052933451998, -89.46872705059165 19.700223438166425, -89.44812363577496 19.698222897087547, -89.41262236716776 19.649300574340508, -89.29660929296921 19.55109219410481, -89.14667982822627 19.423785034540018, -89.14699680383883 19.281564750569064, -89.14699680383883 19.13297910861987, -89.13621963301165 19.132251639136644, -89.14699680383883 18.995123641548282, -89.14889865751422 18.877273585265446, -89.14446099893831 18.75596804893728, -89.15238538925243 18.735598903406913, -89.15016655996448 18.45079460072339, -89.12544246218445 18.450612733352585, -89.12132177922112 18.38568608197454, -89.13812148668703 18.385504214603735, -89.13241592566087 18.293479324975472, -89.15206841363987 18.293479324975472, -89.15840792589115 18.221096111394345, -89.1428761208755 18.224187856698062, -89.14319309648806 18.14580301988031, -89.20056568236221 18.144529948284664, -89.20278451165015 18.083240644322757, -89.14446099893831 18.08251317483953, -89.16347953569218 18.057779212409798, -89.16284558446705 18.018313992944712, -89.2069051946135 18.020860136136008, -89.20627124338837 17.95393294367909, -89.15238538925243 17.953569208937477, -89.15238538925243 17.940292890868577, -89.15206841363987 17.815350007124273, -89.49281719714654 17.814622537641046, -90.24563427698686 17.81553187449508, -90.36069642434772 17.812803863932977, -90.58670003610611 17.8160774766075, -90.987674186 17.815350007124273, -90.98799116161257 17.962298842736203, -91.1201699920519 17.963390046961045, -91.14457711421936 17.975029558692682, -91.21779848072173 17.974847691321877, -91.32842296950668 18.06287149879239, -91.3851616041557 18.064144570388038, -91.43746258022881 18.083786246435178, -91.51638950775734 18.130526160732536, -91.51575555653221 18.169991380197622, -91.53445711767351 18.146166754621927, -91.57249419118124 18.141983805093368, -91.61116521591408 18.09524389079601, -91.62194238674127 17.942657166689067, -91.6127500939769 17.912830917876743, -91.63874209420717 17.873911300524078, -91.67202453352644 17.89446231342525, -91.73890638777752 17.93592807396921, -91.77123790025908 17.944293973026326, -91.80452033957833 17.97230154813058, -91.86728151086608 17.98321359037899, -91.9097562429497 18.01376730867454, -91.96681185321128 18.015767849753416, -91.9791739021013 18.04286608800364, -92.01309029264567 18.05141385443156, -92.04161809777646 18.09797190135811, -92.10818297641498 18.093607084458746, -92.16080092810066 18.155260123162268, -92.14907283043578 18.210184069145935, -92.17918551362939 18.26874536254574, -92.17157809892785 18.338946167677182, -92.17601575750375 18.458251162926473, -92.33165078327285 18.460251704005348, -92.36208044207902 18.461524775600996, -92.41438141815215 18.48734994225557, -92.42610951581702 18.55700514527459, -92.46604844300013 18.61647577552843, -92.46921819912578 18.650848708610923, -92.38585361302135 18.66667116987112, -92.20422658702198 18.6794018858276, -91.99121897537873 18.69904356187474, -91.95698560922179 18.697406755537475, -91.90912229172457 18.63611745157557, -91.85555341320119 18.611383489145837, -91.84224043747349 18.66248822034256, -91.7408082414529 18.680129355310825, -91.63874209420717 18.733052760215617, -91.49863887345374 18.79052284939058, -91.40576501897239 18.881820269535616, -91.29577448141255 18.944200777722365, -91.18483301701504 18.994396172065056, -91.11319652857549 19.035316330496595, -91.08118199170649 19.0673249877586, -90.9930627714136 19.11988465792178, -90.89987194131969 19.183356370333367, -90.76293847669189 19.302661365582658, -90.72268257389621 19.359222117903588, -90.72521837879673 19.40105161318916, -90.70303008591722 19.483801266906276, -90.71190540306903 19.562186103724027, -90.68591340283875 19.630386367776595, -90.70619984204286 19.64966430908212, -90.69320384192773 19.6889476611764, -90.66150628067129 19.75860286419542, -90.623152231551 19.793703266761142, -90.50935798664041 19.86608648034227, -90.44754774219035 19.9599300436786, -90.44723076657779 19.95938444156618, -90.44754774219035 19.9599300436786, -90.47258881558294 19.993211772536252, -90.46307954720601 20.014490254920652, -90.49129037672424 20.0608664344764, -90.48051320589705 20.09651243915454, -90.48875457182372 20.142343016597867, -90.48209808395987 20.210543280650434, -90.48907154743628 20.215635567033026, -90.48970549866141 20.33130321486618, -90.48399993763526 20.37149590381449, -90.50238452316398 20.497711859154442, -90.44818169341548 20.633566785147156, -90.4551551568919 20.699220906008428, -90.41141252235802 20.75850966889146, -90.41585018093392 20.81216054327948, -90.40443905888161 20.846533476361973, -90.37939798548902 20.848352150070042, -90.38193379038954 20.749598167721924))",2023,Total,950291,945445,950291,4846,4846,0.51
31,,23,Quintana Roo,"MULTIPOLYGON (((-87.36210712948898 18.384958612491314, -87.3823935686931 18.37422843761371, -87.322802153531 18.456432489218404, -87.36210712948898 18.384958612491314)), ((-87.27367093358353 18.739418118193857, -87.24577707967786 18.68503977432261, -87.24767893335326 18.645028952745104, -87.27367093358353 18.739418118193857)), ((-86.73227658732362 20.56536652109459, -86.76334019735492 20.5071689624364, -86.81817697832857 20.43842309627141, -86.83085600283114 20.43787749415899, -86.89900575953247 20.344033930822658, -86.9877589310505 20.27183258461234, -87.0213583459823 20.338941644440066, -87.01723766301897 20.411688592762804, -86.92753356466326 20.551180866171656, -86.8977378570822 20.56536652109459, -86.86984400317655 20.537358945990334, -86.81564117342805 20.542451232372926, -86.72403522139695 20.590464218265936, -86.73227658732362 20.56536652109459)), ((-86.80201122208778 21.211905024312927, -86.80296214892547 21.15970908889136, -86.74083492886285 21.13733940228212, -86.77982292920828 21.060227637060017, -86.82102975884163 21.0040306194807, -86.84638780784678 20.904731035020163, -86.87364771052732 20.84907961955327, -86.91517151577325 20.81034186957141, -86.96430273572072 20.747779494013855, -86.9627178576579 20.730502093787205, -87.0080453702546 20.70431319239102, -87.02167532159487 20.674486943578696, -87.12247356639034 20.575551093859772, -87.12913005425419 20.569185735881533, -87.24672800651555 20.484799275827157, -87.30346664116458 20.410415521167156, -87.35228088549948 20.322937315809064, -87.35640156846283 20.311479671448232, -87.42391737393903 20.226002007169015, -87.47399952072419 20.100877256053906, -87.47970508175035 20.041588493170874, -87.46544117918496 19.95938444156618, -87.4331096667034 19.908461577740262, -87.47336556949907 19.937196622327743, -87.45561493519547 19.874088644657768, -87.50030849656704 19.806979584830042, -87.57828449725787 19.79042965408662, -87.64009474170791 19.692766875963343, -87.74089298650338 19.666032372454737, -87.73645532792747 19.585465127187305, -87.70222196177053 19.55000098987997, -87.67686391276538 19.56382291006129, -87.66989044928897 19.50089679976212, -87.65150586376024 19.504170412436643, -87.61568761954047 19.552547133071265, -87.55007366773964 19.56600531851097, -87.52598352118476 19.540543886598012, -87.49238410625293 19.57055200278114, -87.50728196004346 19.586738198782953, -87.45212820345726 19.5960134346941, -87.44895844733162 19.63184130674305, -87.41060439821133 19.59837771051459, -87.44040010579238 19.468888142500116, -87.49650478921626 19.432696535709553, -87.52313074067168 19.39705053103141, -87.55419435070297 19.426876779843735, -87.63597405874458 19.37340777282652, -87.65055493692255 19.339398574485642, -87.66133210774973 19.26046813555547, -87.68700713236744 19.234824836271706, -87.68320342501667 19.204998587459382, -87.62995152210586 19.183356370333367, -87.60712927800122 19.22991441725992, -87.54626996038887 19.302843232953464, -87.50569708198063 19.322303041629798, -87.44610566681854 19.313027805718647, -87.53961347252502 19.19990630107679, -87.54975669212708 19.088967204884614, -87.56402059469248 19.067143120387794, -87.63217035139381 18.92310416270877, -87.64421542467126 18.856176970251852, -87.66260001019998 18.827805660405986, -87.67369415663974 18.752330701521142, -87.71331610821028 18.706681991448626, -87.72536118148773 18.668489843579188, -87.74025903527826 18.54554750091376, -87.76276430377033 18.494442769717036, -87.76403220622058 18.417876606607354, -87.81950293841933 18.33203520758652, -87.83281591414705 18.295479866054347, -87.84422703619936 18.19090612784041, -87.86736625591655 18.1879962499075, -87.9025505489112 18.14252940720579, -87.9256897686284 18.159988674803245, -88.03029172077463 18.16035240954486, -88.03029172077463 18.414784861303637, -88.24963884466916 18.415512330786864, -88.24995582028173 18.472982419961827, -88.32698089413486 18.49007795281767, -88.38752323613465 18.481893921131363, -88.40083621186236 18.49589770868349, -88.44299396833341 18.48098458427733, -88.47786128571549 18.49407903497542, -88.5187511397363 18.462070377713417, -88.54474313996657 18.35931531320755, -88.60591943319149 18.291296916525788, -88.60465153074124 18.241465256924712, -88.69784236083515 18.18217649404168, -88.69055192174616 18.154896388420653, -88.71876275126439 18.108702076235716, -88.71686089758902 18.060325355601094, -88.77074675172494 18.029044167822317, -88.78437670306522 17.97993997770447, -88.8832730941853 17.89628098713332, -88.93335524097046 17.93083578758662, -88.94571728986047 17.959388964803296, -88.98565621704358 17.955751617387158, -89.02876490035233 17.99721737793112, -89.07631124223698 17.99376189788579, -89.1340008037237 17.971028476534933, -89.15238538925243 17.940292890868577, -89.15238538925243 17.953569208937477, -89.20627124338837 17.95393294367909, -89.2069051946135 18.020860136136008, -89.16284558446705 18.018313992944712, -89.16347953569218 18.057779212409798, -89.14446099893831 18.08251317483953, -89.20278451165015 18.083240644322757, -89.20056568236221 18.144529948284664, -89.14319309648806 18.14580301988031, -89.1428761208755 18.224187856698062, -89.15840792589115 18.221096111394345, -89.15206841363987 18.293479324975472, -89.13241592566087 18.293479324975472, -89.13812148668703 18.385504214603735, -89.12132177922112 18.38568608197454, -89.12544246218445 18.450612733352585, -89.15016655996448 18.45079460072339, -89.15238538925243 18.735598903406913, -89.14446099893831 18.75596804893728, -89.14889865751422 18.877273585265446, -89.14699680383883 18.995123641548282, -89.13621963301165 19.132251639136644, -89.14699680383883 19.13297910861987, -89.14699680383883 19.281564750569064, -89.14667982822627 19.423785034540018, -89.29660929296921 19.55109219410481, -89.21990119472864 19.608016681167353, -89.22307095085428 19.63656985838403, -89.14509495016344 19.63747919523806, -89.14953260873935 19.581282177658746, -89.10895973033111 19.58237338188359, -89.10832577910598 19.612381498066718, -89.13368382811113 19.614382039145593, -89.12385758412164 19.70331518347014, -89.07409241294903 19.694221814929797, -89.0360553394413 19.67803561892799, -89.03098372964028 19.708771204594346, -88.99738431470846 19.7049519898074, -88.99516548542051 19.727321676416643, -89.04873436394388 19.721501920550825, -89.02527816861412 19.776789601276107, -88.95681143630023 19.816618555482805, -88.9454003142479 19.791702725682267, -88.91148392370351 19.800977961593418, -88.90038977726377 19.861176061330482, -88.88042031367222 19.87790785944471, -88.83319094740013 19.878271594186327, -88.78342577622752 20.007943029571607, -88.70037816573567 20.010307305392097, -88.69055192174616 20.08960147906388, -88.62113426259458 20.131612841720262, -88.57675767683557 20.148162772463685, -88.50765699329654 20.1432523534519, -88.50258538349551 20.18999226774926, -88.52001904218655 20.192174676198942, -88.4093945534016 20.252009041194395, -88.30891328421869 20.25346398016085, -88.26485367407224 20.29038305643464, -88.23252216159068 20.290019321693023, -88.13679552659625 20.281107820523488, -88.06484206254414 20.349489951946865, -87.9932055741046 20.423873706606862, -87.99510742777998 20.447334597440946, -87.96277591529842 20.44660712795772, -87.93836879313096 20.47024988616261, -87.74437971824159 20.653754063306717, -87.57828449725787 20.92564578266295, -87.53327396027373 20.999665802581337, -87.53517581394912 21.4901621016474, -87.48572761838908 21.483069274185933, -87.46544117918496 21.456880372789747, -87.4375473252793 21.468883619263, -87.35449971478744 21.446332065282952, -87.2232718111858 21.431237073505983, -87.11169639556314 21.47106602771268, -87.10377200524904 21.54617725185591, -87.12913005425419 21.554543150913023, -87.08570439533287 21.58946168610794, -87.06605190735388 21.57036561217322, -86.97571385777304 21.54672285396833, -86.95289161366841 21.48852529531014, -86.88664371064246 21.403411365772534, -86.84860663713474 21.251733978519624, -86.83148995405627 21.253734519598503, -86.82198068567934 21.314114486706373, -86.79693961228675 21.330664417449796, -86.79503775861136 21.36558295264471, -86.82198068567934 21.419961296515957, -86.79662263667419 21.408503652155126, -86.7902831244229 21.34557754185596, -86.81532419781549 21.27574047146613, -86.80201122208778 21.211905024312927)), ((-87.11106244433802 21.59400837037811, -87.13895629824368 21.56236344785772, -87.19537795728013 21.53344653589943, -87.24799590896582 21.525080636842315, -87.31804751934254 21.52762678003361, -87.32565493404408 21.548359660305593, -87.3957065444208 21.51435046196471, -87.33389629997076 21.566000795273855, -87.27018420184532 21.54035749599009, -87.2090079086204 21.54672285396833, -87.14751463978291 21.571093081656446, -87.11708498097674 21.597100115681826, -87.11106244433802 21.59400837037811)))",2023,Total,2019606,1977161,2019606,42445,42445,2.15
